price,bedrooms,bathrooms,sqft_living,sqft_lot,floors,condition,sqft_above,sqft_basement,zipcode
538000.0,3,2.25,2570,7242,2.0,3,2170,400,98125
510000.0,3,2.0,1680,8080,1.0,3,1680,0,98074
257500.0,3,2.25,1715,6819,2.0,3,1715,0,98003
323000.0,3,2.5,1890,6560,2.0,3,1890,0,98038
400000.0,3,1.75,1370,9680,1.0,4,1370,0,98074
395000.0,3,2.0,1890,14040,2.0,3,1890,0,98019
329000.0,3,2.25,2450,6500,2.0,4,2450,0,98030
719000.0,4,2.5,2570,7173,2.0,3,2570,0,98052
580500.0,3,2.5,2320,3980,2.0,3,2320,0,98027
640000.0,4,2.0,2360,6000,2.0,4,2360,0,98107
625000.0,4,2.5,2570,5520,2.0,3,2570,0,98074
785000.0,4,2.5,2290,13416,2.0,4,2290,0,98007
450000.0,3,1.75,1250,5963,1.0,4,1250,0,98115
600000.0,3,1.75,1410,4080,1.0,4,1000,410,98117
292500.0,4,2.5,2250,4495,2.0,3,2250,0,98042
301000.0,3,2.5,2420,4750,2.0,3,2420,0,98042
650000.0,3,2.25,2150,21235,1.0,4,1590,560,98166
289000.0,3,1.75,1260,8400,1.0,3,1260,0,98148
425000.0,3,2.25,1660,6000,1.0,3,1110,550,98122
287000.0,4,2.5,2240,4648,2.0,3,2240,0,98001
325000.0,3,2.0,1260,5612,1.0,4,1260,0,98034
360000.0,4,2.5,2380,5000,2.0,3,2380,0,98038
390000.0,3,2.5,2350,5100,2.0,3,2350,0,98038
360000.0,4,2.5,1900,5889,2.0,3,1900,0,98038
356000.0,3,1.5,1680,8712,1.0,3,1680,0,98059
243500.0,4,2.5,1980,7403,2.0,3,1980,0,98023
430000.0,3,1.5,1580,5000,1.0,3,1290,290,98117
700000.0,3,1.5,1580,5000,1.0,3,1290,290,98117
247500.0,3,1.75,1960,15681,1.0,3,1960,0,98032
437500.0,3,2.5,2320,36847,2.0,3,2320,0,98045
555000.0,3,2.0,1980,3478,1.5,4,1440,540,98117
597750.0,4,2.5,2310,9624,2.0,3,2310,0,98027
272500.0,3,1.75,1540,12600,1.0,4,1160,380,98038
391500.0,3,2.0,1450,9132,1.0,3,1450,0,98034
445000.0,3,2.25,2100,8201,1.0,3,1620,480,98178
430000.0,4,2.5,2070,4310,2.0,3,2070,0,98065
660500.0,4,2.25,2010,9603,1.0,3,1440,570,98027
453246.0,3,2.5,2010,2287,2.0,3,1390,620,98029
199000.0,3,1.75,1320,17390,1.0,4,1320,0,98003
500000.0,4,2.25,2030,8517,1.0,4,1380,650,98006
532170.0,3,2.0,1360,3090,2.0,3,1360,0,98103
247000.0,3,2.0,1270,7198,1.5,3,1270,0,98022
320000.0,4,1.75,1760,11180,1.0,4,1760,0,98059
438000.0,3,1.75,1780,9660,1.0,3,1780,0,98034
370000.0,3,1.75,1580,7000,1.0,3,1180,400,98034
284000.0,3,1.75,1560,21000,1.0,3,1560,0,98166
272000.0,3,1.75,2160,7140,1.0,4,1670,490,98023
313000.0,3,1.5,1340,7912,1.5,3,1340,0,98133
673000.0,4,2.25,2590,8190,2.0,4,2590,0,98006
269950.0,3,1.5,1950,7560,1.0,4,1320,630,98022
260000.0,3,2.5,1670,5797,2.0,3,1670,0,98030
269000.0,4,1.75,1490,10000,1.0,4,1100,390,98023
560000.0,3,2.5,1900,8744,2.0,3,1900,0,98074
305000.0,3,1.75,1650,9480,1.0,3,1220,430,98034
799000.0,3,2.5,2140,9897,1.0,4,2140,0,98040
256883.0,3,2.5,1690,5025,2.0,3,1690,0,98023
465000.0,3,2.5,2150,4084,2.0,3,2150,0,98126
297000.0,3,2.5,1940,14952,2.0,3,1940,0,98042
677900.0,3,2.5,2440,4587,2.0,3,2440,0,98052
320000.0,4,2.25,1550,7579,2.0,3,1550,0,98038
625504.0,3,2.25,1270,1566,2.0,3,1060,210,98105
592500.0,4,2.5,2240,12032,1.0,3,2240,0,98074
477000.0,4,2.75,1720,6270,2.0,3,1720,0,98118
445838.0,3,2.5,2250,5692,2.0,3,2250,0,98146
279950.0,3,2.0,1750,9750,1.0,3,1350,400,98198
527000.0,4,2.25,2330,19436,2.0,3,2330,0,98011
325000.0,3,2.25,2220,16020,1.0,4,1780,440,98030
328000.0,3,2.25,2020,8379,2.0,3,2020,0,98038
264950.0,4,2.25,1720,9753,1.0,4,1120,600,98023
516500.0,3,2.5,1480,4729,2.0,3,1480,0,98053
225000.0,3,1.75,1430,8505,1.0,4,1430,0,98003
250000.0,4,2.0,2010,7312,1.0,4,2010,0,98002
260000.0,3,2.0,1810,7209,1.0,4,1240,570,98032
415000.0,3,2.25,1510,36224,2.0,3,1510,0,98045
245000.0,3,2.5,1730,7442,2.0,3,1730,0,98030
315000.0,3,1.75,1580,11455,1.0,4,1200,380,98059
693000.0,4,2.5,2460,4425,2.0,3,2460,0,98052
237000.0,3,1.75,1270,8470,1.0,4,1270,0,98198
290000.0,4,2.5,1700,7280,2.0,4,1700,0,98031
272500.0,3,2.5,2070,9900,1.0,3,1420,650,98023
455000.0,4,2.5,2210,49375,1.0,3,2210,0,98038
405000.0,3,1.75,1670,6720,1.0,3,1140,530,98034
389999.0,4,2.5,1890,15770,2.0,4,1890,0,98166
360000.0,4,2.5,2160,9528,2.0,3,2160,0,98001
265000.0,3,2.0,1320,8959,1.0,3,1320,0,98042
404000.0,3,1.5,2030,8880,1.0,3,1330,700,98108
267500.0,3,1.75,1590,11914,1.0,3,1090,500,98188
335000.0,3,2.5,2440,7632,2.0,3,2440,0,98003
208633.0,3,2.5,2040,3810,2.0,3,2040,0,98038
550000.0,4,2.75,1800,7750,1.0,4,1400,400,98177
610750.0,4,2.25,2180,7297,2.0,3,2180,0,98074
305000.0,4,2.25,1950,7700,1.0,3,1350,600,98058
520000.0,3,2.25,2030,16200,2.0,3,2030,0,98027
230000.0,3,2.0,1450,11204,1.0,3,1450,0,98001
240000.0,3,1.75,1510,10248,1.0,3,1510,0,98023
740000.0,4,2.0,2050,4400,1.5,4,2050,0,98102
295000.0,3,2.0,1810,10530,1.0,3,1810,0,98022
260000.0,4,2.5,1960,5238,2.0,3,1960,0,98038
265000.0,3,1.75,1420,8250,1.0,3,1420,0,98133
245000.0,3,1.75,1740,11547,1.0,3,1740,0,98178
485000.0,4,1.75,2560,43995,2.0,4,2560,0,98052
309600.0,4,1.75,1275,20000,1.0,4,1275,0,98070
552250.0,4,2.5,2580,5823,2.0,3,2580,0,98065
206600.0,3,2.0,1390,13464,1.0,4,1390,0,98030
855000.0,4,2.75,2270,10460,2.0,3,2270,0,98040
252000.0,4,1.5,1550,19800,1.0,4,1050,500,98001
300000.0,4,2.5,1910,4862,2.0,3,1910,0,98038
679900.0,3,2.5,2440,5750,2.0,3,1980,460,98116
463000.0,3,2.5,1640,29970,2.0,3,1640,0,98053
329500.0,4,2.5,1820,7912,2.0,3,1820,0,98038
465000.0,3,2.0,1840,40438,2.0,3,1840,0,98045
280000.0,3,2.25,1430,7222,2.0,3,1430,0,98056
297000.0,3,2.25,1450,7562,2.0,3,1450,0,98056
450000.0,3,1.75,1640,13500,1.0,3,1110,530,98125
595000.0,4,2.0,2020,2849,2.0,3,2020,0,98115
435000.0,3,1.5,1300,3348,1.5,3,1300,0,98144
389000.0,4,2.25,2130,5337,2.0,3,2130,0,98019
799000.0,4,2.25,2510,11585,2.0,4,2510,0,98040
365500.0,3,2.0,1410,9600,1.0,4,1410,0,98072
252350.0,3,2.0,1650,7352,1.0,3,1160,490,98058
403950.0,4,2.5,2120,13780,2.0,3,2120,0,98146
385000.0,4,1.5,2040,10726,1.0,3,1380,660,98177
490000.0,3,2.75,1980,3128,2.0,4,1980,0,98008
330000.0,3,2.5,1600,26977,2.0,3,1600,0,98019
269900.0,4,1.75,1530,8750,1.5,4,1530,0,98058
437000.0,3,2.5,1750,22357,2.0,3,1750,0,98045
322500.0,4,2.5,1820,6753,2.0,3,1820,0,98038
278500.0,3,2.0,1570,5250,1.0,3,1570,0,98092
364950.0,4,2.5,1930,6957,2.0,3,1930,0,98055
268000.0,3,2.5,1550,8134,2.0,3,1550,0,98031
577500.0,3,2.5,2000,7251,2.0,3,2000,0,98034
339000.0,4,1.5,2390,7480,1.5,3,2390,0,98178
355000.0,3,2.25,1860,5028,2.0,3,1860,0,98019
538000.0,3,2.5,2250,11632,2.0,3,2250,0,98056
380000.0,3,2.5,2280,10255,2.0,4,2280,0,98058
397000.0,4,2.0,1440,7680,1.0,3,1200,240,98034
365000.0,3,2.5,2200,4052,2.0,3,2200,0,98058
237000.0,3,2.5,1490,2138,2.0,3,1490,0,98055
525000.0,4,2.5,2450,5280,2.0,3,2450,0,98011
749000.0,4,2.5,1710,9627,1.0,3,1440,270,98006
578000.0,3,1.75,2120,10875,1.0,3,1540,580,98146
196000.0,3,2.25,2070,11576,2.0,3,2070,0,98001
400000.0,3,1.75,1920,9102,1.0,3,1920,0,98072
505000.0,3,2.0,1260,5460,1.0,3,1260,0,98034
333500.0,3,1.75,1220,9732,1.0,3,1220,0,98011
691100.0,3,2.75,2360,16117,1.0,4,1710,650,98006
811000.0,3,1.75,1870,9897,1.0,4,1870,0,98040
496500.0,3,2.5,2260,3640,2.0,3,2260,0,98072
348000.0,3,2.25,2570,8491,2.0,4,2570,0,98042
230000.0,3,2.0,1510,3413,2.0,3,1510,0,98031
359500.0,4,2.25,2390,11250,2.0,3,2390,0,98023
465000.0,3,1.75,1480,6360,1.0,3,1480,0,98133
325000.0,4,2.5,1850,7324,2.0,3,1850,0,98042
340500.0,3,2.0,2270,28025,1.0,4,1920,350,98168
342500.0,3,2.5,1810,5192,2.0,3,1810,0,98038
520000.0,4,2.25,1890,3006,2.0,3,1890,0,98029
460000.0,3,2.5,1610,2527,2.0,3,1080,530,98118
328500.0,3,2.5,1950,8130,2.0,4,1950,0,98042
295000.0,4,2.5,2160,7725,1.0,4,1460,700,98023
370000.0,3,2.0,1680,5036,1.0,4,1680,0,98055
397500.0,3,2.0,1510,6710,1.0,3,1070,440,98034
725000.0,4,2.0,2110,4140,2.0,3,1710,400,98116
437500.0,3,2.5,2120,4500,2.0,3,2120,0,98065
342000.0,3,2.0,1930,11947,1.0,4,1930,0,98042
280000.0,3,1.5,1670,11610,1.0,4,1670,0,98055
480000.0,4,2.5,2600,7787,2.0,3,2600,0,98059
750000.0,3,2.5,2400,7745,2.0,3,2400,0,98033
235000.0,4,1.5,1690,11054,1.0,4,1690,0,98055
662000.0,3,1.75,2500,36947,1.0,3,2500,0,98052
270500.0,3,2.5,1780,7848,1.0,3,1320,460,98038
358000.0,3,2.25,1610,6655,2.0,4,1610,0,98058
452000.0,4,1.75,1570,8268,1.0,3,1570,0,98011
249000.0,3,2.0,1360,6082,1.0,3,1360,0,98042
346900.0,4,2.5,1970,5106,2.0,3,1970,0,98055
280000.0,4,2.5,1560,4350,2.0,3,1560,0,98056
318888.0,4,1.75,2320,12000,1.0,4,2270,50,98032
530000.0,3,2.25,2120,40518,1.0,3,2120,0,98075
375000.0,3,2.25,2120,18500,2.0,4,2120,0,98031
782000.0,4,2.5,2380,9614,2.0,4,2380,0,98006
451000.0,3,1.75,1790,9813,2.0,3,1790,0,98155
331500.0,4,2.5,2050,10271,2.0,3,2050,0,98042
638700.0,3,1.75,2080,9162,1.0,3,1370,710,98005
435000.0,3,2.5,1840,5680,2.0,3,1840,0,98053
338900.0,4,2.5,1830,5612,2.0,3,1830,0,98038
263500.0,3,1.75,1330,9917,1.0,3,1040,290,98058
266000.0,3,2.5,1805,3402,2.0,3,1805,0,98002
530000.0,4,2.5,2320,5493,2.0,3,2320,0,98028
264000.0,3,1.5,1820,10608,1.0,4,1820,0,98003
439000.0,4,2.25,2060,10070,2.0,3,2060,0,98034
268500.0,4,1.75,1420,7500,1.0,4,1080,340,98031
330000.0,3,1.75,1510,15744,1.0,3,1510,0,98045
640000.0,3,2.5,2160,4000,1.5,3,1960,200,98122
370000.0,3,2.25,2110,13300,2.0,4,2110,0,98038
265000.0,3,1.75,1820,32666,1.0,4,1820,0,98022
290000.0,3,2.5,1610,2937,2.0,3,1610,0,98055
296000.0,4,2.5,1780,3600,2.0,3,1780,0,98038
360000.0,4,2.5,1840,9611,2.0,3,1840,0,98178
240500.0,3,1.75,1460,10584,1.0,3,990,470,98168
399950.0,4,2.0,2420,31465,1.0,3,2420,0,98092
185000.0,3,1.75,1430,10816,2.0,3,1430,0,98010
460000.0,3,1.75,1440,7070,1.0,3,1440,0,98052
435500.0,3,2.25,1450,4789,2.0,3,1450,0,98029
223000.0,3,2.0,1670,6824,1.0,3,1300,370,98042
650000.0,3,2.0,1870,3388,1.0,4,1230,640,98199
533600.0,3,2.5,1930,5080,2.0,4,1930,0,98029
695000.0,3,2.75,2540,4694,2.0,3,2540,0,98074
242000.0,3,1.75,1280,7524,1.5,4,1280,0,98031
425000.0,3,2.25,1820,8814,1.0,3,1280,540,98125
525000.0,3,2.25,1490,9414,2.0,3,1490,0,98052
485000.0,3,2.5,1880,5502,2.0,3,1880,0,98029
210000.0,3,2.0,1440,7210,1.0,3,1440,0,98092
260000.0,3,2.5,1920,7415,2.0,3,1920,0,98031
577000.0,3,2.5,2060,5750,1.0,3,1330,730,98116
200000.0,3,1.5,1210,10588,1.0,4,1210,0,98002
543500.0,3,2.25,1270,2790,1.0,3,990,280,98199
650000.0,3,2.5,2690,11575,1.0,3,2130,560,98028
314500.0,3,2.0,2050,13303,1.0,3,2050,0,98003
430000.0,3,2.5,2360,6699,2.0,3,2360,0,98065
240000.0,3,1.75,1760,6500,1.0,3,1150,610,98038
545000.0,3,1.75,1680,6200,1.5,3,1680,0,98136
521000.0,4,1.75,2020,36400,1.0,4,1550,470,98077
337000.0,3,2.5,1470,3976,2.0,3,1470,0,98065
888000.0,3,1.5,1250,8710,1.0,4,1250,0,98004
496500.0,4,2.5,2250,14440,1.0,3,1550,700,98027
475000.0,3,2.5,1640,5097,2.0,3,1640,0,98155
331000.0,3,1.75,1300,9079,1.0,3,1300,0,98059
290000.0,3,1.5,1950,15954,1.0,4,1950,0,98003
865000.0,4,1.75,1800,4180,2.0,4,1800,0,98102
385000.0,3,1.75,1800,18000,1.0,3,1200,600,98058
497000.0,3,2.25,1870,9315,1.0,3,1350,520,98034
222000.0,3,2.0,1440,7187,1.0,4,970,470,98023
373000.0,3,1.75,1830,11788,1.0,3,1430,400,98055
359900.0,4,2.25,2470,7698,2.0,3,2470,0,98058
245000.0,3,2.0,1410,5760,1.0,3,1410,0,98030
268000.0,4,1.75,1680,9966,1.0,3,1100,580,98198
485000.0,4,2.0,1400,3600,1.0,3,1100,300,98119
440000.0,3,1.75,1530,7245,1.0,4,1530,0,98034
390000.0,4,2.5,2340,8548,2.0,3,2340,0,98031
243000.0,3,1.75,1450,12125,1.0,4,1450,0,98001
639000.0,4,2.5,2210,9875,2.0,3,2210,0,98074
267000.0,3,2.0,1300,9644,1.0,3,1300,0,98010
289950.0,3,2.5,1670,6186,2.0,3,1670,0,98038
636000.0,3,2.5,2140,2770,2.0,3,1770,370,98052
328000.0,3,1.75,1470,7650,1.0,3,1130,340,98059
315000.0,3,2.25,1540,17424,2.0,3,1540,0,98045
403000.0,3,2.75,2090,8354,2.0,3,2090,0,98019
550000.0,3,2.0,2380,17950,2.0,4,2110,270,98155
347500.0,4,2.5,2156,3562,2.0,3,2156,0,98030
365000.0,4,2.25,2070,8893,2.0,4,2070,0,98058
605000.0,3,1.75,1920,7400,1.0,4,1260,660,98006
233000.0,3,2.0,1400,9177,1.0,3,1400,0,98001
360000.0,4,2.5,2210,17715,2.0,3,2210,0,98030
650000.0,4,1.75,2010,5070,1.0,4,1300,710,98116
449950.0,3,2.5,2170,4912,2.0,3,2170,0,98028
517500.0,3,1.5,1430,5200,1.0,4,1250,180,98117
435000.0,4,1.5,1510,6460,1.0,3,1070,440,98034
316500.0,3,1.75,1600,14250,1.0,3,1070,530,98023
856600.0,4,2.25,2400,13430,1.0,4,2400,0,98005
565000.0,4,2.5,2440,22594,2.0,3,2440,0,98053
400000.0,3,2.25,1190,1149,2.0,3,1050,140,98116
560000.0,3,2.25,2060,31400,2.0,3,2060,0,98074
269950.0,3,2.5,1890,4838,2.0,3,1730,160,98168
320000.0,3,1.5,1240,1221,2.0,3,1050,190,98133
460000.0,4,2.0,2090,40419,1.0,4,2090,0,98027
408200.0,3,2.5,1800,5761,2.0,4,1800,0,98106
522000.0,3,1.75,1730,8400,1.0,4,1400,330,98052
470000.0,3,2.5,2100,4700,2.0,3,2100,0,98065
650000.0,3,2.0,1340,2720,1.5,3,1340,0,98103
422120.0,3,2.5,1630,4534,2.0,3,1630,0,98034
500000.0,3,2.25,1690,4964,2.0,3,1690,0,98029
308000.0,4,2.25,1960,12243,2.0,3,1960,0,98042
581000.0,3,2.5,2600,4438,2.0,3,2600,0,98053
361000.0,3,2.0,1950,8698,1.0,3,1950,0,98042
347000.0,3,2.5,1680,4308,2.0,3,1680,0,98056
625000.0,4,2.25,2220,36085,2.0,3,2220,0,98075
246500.0,3,2.0,1430,8919,1.0,3,1430,0,98022
310950.0,4,2.5,2030,4997,2.0,3,2030,0,98031
465750.0,3,1.5,1260,10350,1.0,3,1260,0,98008
659000.0,4,2.25,2610,24931,2.0,3,2610,0,98075
350000.0,3,2.25,1780,16290,2.0,4,1780,0,98058
270000.0,4,2.25,1900,8600,1.0,4,1900,0,98023
249900.0,3,1.75,1380,14000,1.0,4,1380,0,98001
324500.0,3,1.75,1920,11340,1.0,4,1230,690,98023
332000.0,4,2.5,2470,7780,2.0,3,2470,0,98092
330000.0,3,2.25,2300,35287,2.0,3,2300,0,98022
352000.0,3,2.25,1640,11050,1.0,4,1640,0,98059
664000.0,4,2.0,1530,4080,1.5,4,1530,0,98105
512000.0,3,1.75,1610,12555,1.0,3,1080,530,98052
254000.0,3,2.0,2070,9000,1.0,4,1450,620,98023
535800.0,4,2.5,1900,5790,2.0,3,1900,0,98029
438000.0,3,2.5,1520,1304,2.0,3,1180,340,98136
450000.0,4,1.75,2390,23899,1.0,3,1750,640,98028
370500.0,4,2.5,1790,6120,2.0,3,1790,0,98059
265000.0,3,2.5,1720,6271,2.0,3,1720,0,98038
539900.0,3,1.75,1650,10150,1.0,3,1230,420,98033
280000.0,4,2.5,2050,7416,2.0,3,2050,0,98092
275000.0,3,2.25,1420,8549,2.0,4,1420,0,98038
457500.0,3,2.5,1500,4445,2.0,3,1500,0,98029
642450.0,3,1.75,1830,4160,1.0,3,1230,600,98144
469950.0,3,2.25,1620,8701,1.0,3,1220,400,98007
390000.0,3,2.0,1910,11576,1.0,3,1410,500,98011
225000.0,4,2.25,1800,9350,1.0,3,1800,0,98092
374000.0,3,1.5,1330,10640,1.0,3,1330,0,98011
480000.0,3,2.5,1940,10035,2.0,4,1940,0,98072
209000.0,3,2.0,1230,1340,2.0,3,1020,210,98106
730000.0,4,2.25,2190,9009,2.0,4,1840,350,98033
291500.0,3,1.75,1260,9600,1.0,4,1260,0,98042
800000.0,4,2.5,2570,50308,1.5,3,2570,0,98077
300000.0,3,2.0,1480,6698,1.0,4,1080,400,98058
314950.0,3,2.25,1654,8479,2.0,3,1654,0,98038
234000.0,3,1.75,1420,8738,1.0,4,1420,0,98002
205000.0,3,2.0,1410,8384,1.0,3,1410,0,98001
324000.0,3,2.5,1750,7208,2.0,3,1750,0,98055
324000.0,3,2.5,1920,5322,2.0,3,1920,0,98031
250000.0,3,2.0,1440,9220,1.0,3,1440,0,98198
342000.0,3,1.75,1660,16275,2.0,3,1660,0,98014
255000.0,3,1.5,1340,8450,1.0,4,1340,0,98188
451000.0,3,1.75,1560,4049,1.5,3,1000,560,98126
288400.0,4,2.5,1860,6687,1.0,4,1220,640,98031
420000.0,3,1.5,2390,4600,2.0,3,1750,640,98118
300000.0,3,2.5,1320,2614,2.0,3,1320,0,98118
299900.0,3,2.25,1560,35026,1.0,3,1290,270,98092
253000.0,3,2.5,2020,6564,1.0,3,1310,710,98042
350000.0,3,2.25,1580,47916,1.0,3,1580,0,98024
419000.0,4,1.5,2150,23568,1.0,4,2150,0,98166
260000.0,4,1.75,1810,7480,1.0,3,1230,580,98023
601000.0,3,1.75,1330,6743,1.0,3,1330,0,98125
323000.0,3,1.75,2100,14850,1.0,4,2100,0,98042
335000.0,3,1.75,1570,7500,1.0,3,1300,270,98146
440000.0,3,1.75,1560,7207,1.0,3,1250,310,98034
752500.0,4,2.25,2360,8616,2.0,4,2360,0,98033
532500.0,3,1.75,1330,5000,2.0,4,1210,120,98116
524250.0,3,2.5,1710,3469,2.0,3,1710,0,98029
280000.0,3,2.25,1900,7800,1.0,4,1390,510,98055
283000.0,4,2.75,2130,8560,1.0,3,1560,570,98022
484950.0,3,2.25,1670,5004,2.0,3,1670,0,98029
640000.0,4,1.75,2060,9828,1.0,4,2060,0,98005
585000.0,4,2.5,2160,8158,1.0,4,1660,500,98115
253000.0,3,2.0,1490,7651,1.0,3,1490,0,98003
291000.0,4,2.5,1860,6325,2.0,4,1860,0,98038
289000.0,3,2.0,1850,9550,1.0,3,1850,0,98001
700000.0,4,2.0,1830,4590,2.0,3,1830,0,98105
270000.0,3,2.0,1560,8853,1.0,3,1560,0,98058
258000.0,4,1.75,1730,8320,1.0,3,1230,500,98023
530000.0,3,2.5,1930,7214,2.0,3,1930,0,98125
245000.0,3,2.25,1422,3677,2.0,3,1422,0,98092
563000.0,3,2.0,1380,5000,1.5,4,1380,0,98117
515000.0,3,2.5,2430,4203,2.0,3,2430,0,98065
325000.0,4,2.5,2610,7091,2.0,3,2610,0,98023
900000.0,4,2.25,2460,44431,1.0,4,2460,0,98007
520000.0,4,2.25,1870,7700,2.0,3,1870,0,98052
475000.0,3,1.75,1700,8432,1.0,3,1230,470,98125
321500.0,4,2.5,1930,6228,2.0,3,1930,0,98030
287000.0,3,2.25,1370,6000,2.0,4,1370,0,98038
349500.0,3,1.75,1260,7128,1.0,4,1260,0,98034
315000.0,4,2.5,1930,9643,2.0,4,1930,0,98031
245000.0,3,1.75,1490,6930,1.0,4,1490,0,98030
900000.0,4,2.0,1190,8190,1.5,3,1190,0,98117
415000.0,3,1.75,1480,2200,2.0,3,1480,0,98103
380000.0,4,2.5,2000,6921,2.0,3,2000,0,98038
566000.0,3,2.5,1560,5259,2.0,3,1560,0,98075
470000.0,3,2.25,1780,8784,1.0,3,1230,550,98033
515000.0,3,2.25,1920,11500,1.0,3,1920,0,98006
716500.0,3,1.75,1930,5000,1.0,3,1230,700,98105
648000.0,4,2.5,2380,13435,2.0,3,2380,0,98075
699000.0,3,1.75,1670,5375,1.0,3,1270,400,98199
528000.0,4,2.25,1910,8005,1.0,3,1280,630,98125
425000.0,3,1.75,1560,9452,1.0,4,1560,0,98056
275000.0,3,1.5,1410,9000,1.0,3,1410,0,98133
318000.0,3,2.25,1410,8909,2.0,3,1410,0,98198
208000.0,4,2.75,1810,8677,1.5,3,1810,0,98198
515000.0,3,2.5,2360,11254,1.0,3,2360,0,98003
490000.0,3,1.5,1970,3400,1.5,4,1420,550,98122
225000.0,3,1.5,1370,9000,1.0,3,1370,0,98168
385000.0,4,2.0,1850,11700,1.0,4,1850,0,98059
448000.0,3,2.25,1530,3056,2.0,3,1530,0,98053
430000.0,3,1.75,1810,7300,1.0,4,1240,570,98034
435000.0,3,2.5,1560,3987,2.0,3,1560,0,98053
550000.0,3,2.0,1810,12825,1.0,4,1810,0,98007
285167.0,3,2.25,2200,8375,2.0,3,2200,0,98092
350900.0,4,2.5,2540,12843,2.0,3,2540,0,98030
525000.0,3,1.75,1520,8835,1.0,4,1520,0,98008
262000.0,4,2.5,1560,7800,2.0,3,1560,0,98168
332500.0,3,1.5,1500,6332,1.0,3,1500,0,98125
303000.0,3,2.5,1560,4100,2.0,3,1560,0,98055
605000.0,3,2.5,2570,9487,2.0,3,2570,0,98011
620000.0,4,2.0,1770,7700,1.5,4,1770,0,98007
510000.0,3,2.5,1860,3658,2.0,3,1860,0,98029
510000.0,4,2.5,2430,5203,2.0,3,2430,0,98155
425000.0,4,2.5,1930,14196,1.0,4,1330,600,98072
298900.0,3,2.5,1830,6162,2.0,3,1830,0,98092
305000.0,4,2.5,2230,5000,2.0,3,2230,0,98031
315000.0,3,2.5,1570,2865,2.0,3,1570,0,98118
439995.0,3,1.75,1570,8400,1.0,4,1570,0,98133
605000.0,3,2.5,2010,3667,2.0,3,2010,0,98027
359000.0,3,2.5,1450,3850,2.0,3,1450,0,98065
850000.0,3,1.75,1400,9900,1.0,3,1400,0,98004
505000.0,3,2.0,1500,2500,2.0,3,1500,0,98107
565000.0,3,2.5,2500,7394,2.0,3,2500,0,98072
749950.0,4,2.75,2910,18700,1.0,3,2210,700,98177
334950.0,3,2.5,1620,2930,2.0,3,1620,0,98058
405000.0,3,1.75,1760,5355,1.0,3,1160,600,98118
254000.0,3,2.5,1850,4597,2.0,3,1850,0,98042
472800.0,3,2.25,1840,8400,1.0,3,1290,550,98006
525000.0,4,2.25,1580,7307,1.0,3,1160,420,98027
245000.0,3,2.5,1600,4271,2.0,3,1600,0,98038
455000.0,3,2.5,2090,8653,2.0,3,2090,0,98011
485500.0,4,2.5,2320,3974,2.0,3,2320,0,98065
307000.0,3,1.75,1410,16105,1.0,3,1410,0,98014
320000.0,3,2.5,2280,7417,2.0,3,2280,0,98001
234000.0,3,1.5,1200,11935,1.0,4,1200,0,98042
211000.0,4,2.0,1710,8288,1.5,3,1710,0,98031
349000.0,3,2.25,1640,7261,2.0,3,1640,0,98034
350000.0,4,2.5,2530,10155,2.0,3,2530,0,98042
270000.0,3,1.75,1800,7763,1.0,3,1470,330,98030
438000.0,3,1.75,1650,12940,1.0,4,1650,0,98028
659000.0,4,2.0,1980,23625,2.0,3,1980,0,98072
410500.0,4,2.5,1980,5000,2.0,3,1980,0,98014
295700.0,4,2.5,1720,5805,2.0,3,1720,0,98092
609000.0,4,2.5,2150,37981,2.0,3,2150,0,98052
530000.0,3,2.25,2010,11817,2.0,4,2010,0,98029
390000.0,3,2.5,2500,21780,1.0,3,1770,730,98092
467000.0,3,2.5,1690,6642,2.0,3,1690,0,98053
302495.0,3,2.5,2200,7201,2.0,3,2200,0,98030
441500.0,3,2.5,2420,9592,2.0,3,1780,640,98059
320000.0,3,1.75,2300,12000,1.0,3,1770,530,98133
747500.0,4,2.25,2350,18600,2.0,4,2350,0,98028
403000.0,3,2.5,1700,4125,2.0,3,1700,0,98065
445000.0,3,2.5,2470,4565,2.0,3,2470,0,98056
371025.0,3,2.0,1530,8925,1.0,3,1530,0,98011
425000.0,4,2.75,2440,15349,2.0,4,2440,0,98198
364808.0,3,1.75,2320,7875,1.0,3,1620,700,98058
320000.0,3,2.25,1580,6561,1.0,3,1200,380,98058
350000.0,3,2.25,2470,10290,2.0,3,2230,240,98058
284000.0,3,1.75,1530,9600,1.0,3,1200,330,98042
588000.0,4,2.0,1680,5000,1.0,3,980,700,98115
372500.0,3,1.75,1680,8648,1.0,4,1680,0,98133
375000.0,3,2.5,2050,7205,2.0,3,2050,0,98003
595000.0,3,2.75,2150,31238,2.0,3,2150,0,98014
548000.0,4,2.0,2100,8880,1.0,4,2100,0,98008
234975.0,3,1.75,1650,8073,1.0,3,1100,550,98092
455000.0,3,1.5,1380,6657,2.0,3,1380,0,98034
279950.0,3,1.75,1510,11234,1.0,3,1210,300,98155
267500.0,3,1.5,1600,9072,1.0,4,1600,0,98030
567500.0,3,2.5,2080,4556,2.0,3,2080,0,98074
274500.0,3,2.25,1720,9000,1.0,4,1320,400,98023
464950.0,3,1.5,1200,890,2.0,3,1030,170,98109
620000.0,4,1.75,2350,18800,1.0,3,2350,0,98005
450000.0,4,2.25,2040,9565,1.0,3,1400,640,98133
461000.0,3,2.25,1850,7923,1.0,4,1150,700,98033
643000.0,4,2.5,2270,8391,2.0,3,2270,0,98029
700000.0,3,2.25,2330,11424,2.0,4,2330,0,98052
303700.0,3,2.5,1981,5700,2.0,3,1981,0,98030
672000.0,4,2.5,2440,10049,2.0,4,2440,0,98029
505000.0,3,2.5,1860,8060,2.0,4,1860,0,98029
234000.0,3,1.75,1490,8366,1.0,4,1010,480,98042
503000.0,4,2.5,2470,5044,2.0,3,2470,0,98155
606000.0,4,2.25,2390,8858,1.0,4,1740,650,98033
719000.0,3,2.5,2120,9307,2.0,4,2120,0,98006
381000.0,3,2.0,1770,14400,1.0,4,1770,0,98166
267000.0,3,2.5,2495,4400,2.0,3,2495,0,98001
519900.0,4,2.5,2403,6172,2.0,3,2403,0,98028
465000.0,4,1.75,1810,21650,2.0,4,1810,0,98077
292000.0,4,2.5,2060,5950,2.0,3,2060,0,98030
253000.0,3,1.75,1250,10122,1.0,3,1250,0,98010
658588.0,3,2.25,2560,41346,2.0,3,2560,0,98027
635000.0,4,2.25,1920,8910,1.0,4,1200,720,98005
439000.0,4,2.25,2240,8300,2.0,3,2240,0,98011
300000.0,3,2.5,1260,3855,2.0,3,1260,0,98059
345000.0,3,1.5,1360,13496,1.0,4,1360,0,98198
283500.0,4,2.25,2100,8050,2.0,3,2100,0,98055
685000.0,3,1.75,2210,8955,1.0,3,1560,650,98033
750000.0,3,2.5,2360,12987,2.0,3,2360,0,98006
245000.0,4,1.5,1280,8000,1.0,3,1280,0,98178
241000.0,3,2.0,1650,6000,1.0,3,1650,0,98023
350000.0,3,1.5,1430,12199,1.0,3,1130,300,98133
799000.0,4,2.75,2390,6820,2.0,4,2140,250,98115
290000.0,4,1.75,1990,18900,2.0,4,1870,120,98168
459000.0,3,1.75,1620,7330,1.0,4,1090,530,98034
264950.0,3,1.5,1470,11599,1.0,3,1070,400,98030
491500.0,3,2.25,2230,13100,1.0,4,1510,720,98006
566000.0,3,2.5,2090,6294,2.0,3,2090,0,98052
290000.0,3,2.25,1500,7308,1.0,4,1210,290,98055
352500.0,3,1.75,1860,7881,1.0,3,1160,700,98198
235867.0,4,2.0,1330,5926,1.0,4,1330,0,98056
500000.0,3,2.25,1760,11946,2.0,3,1760,0,98074
382000.0,3,2.25,1800,4500,2.0,3,1800,0,98019
359000.0,4,1.5,1890,6052,1.0,4,1890,0,98125
400000.0,4,1.5,1390,7200,1.0,3,1140,250,98133
519500.0,4,2.0,1540,17859,1.0,3,1540,0,98027
280000.0,4,2.25,2100,8075,2.0,3,2100,0,98003
515000.0,4,1.75,1730,7980,1.0,4,1730,0,98007
400000.0,3,2.25,1500,2692,2.0,3,1500,0,98034
652100.0,3,2.5,2380,5017,2.0,3,2380,0,98074
701000.0,4,1.5,1840,10080,2.0,3,1840,0,98118
640000.0,4,2.5,2341,9594,2.0,3,2341,0,98052
455800.0,3,2.5,1690,4584,2.0,3,1690,0,98053
504750.0,3,2.5,2490,21937,2.0,3,2490,0,98014
514000.0,3,1.5,1610,9964,1.0,3,1080,530,98052
532000.0,3,2.25,1910,35015,1.0,4,1430,480,98027
521000.0,3,1.75,1730,18250,1.0,3,1730,0,98011
577000.0,4,2.25,2360,7490,2.0,3,2360,0,98033
495000.0,4,2.5,2460,4862,2.0,3,2460,0,98028
249000.0,3,1.5,1700,8247,1.0,3,1010,690,98031
230000.0,4,2.0,1220,9100,1.5,4,1220,0,98023
442000.0,4,2.5,2520,7253,2.0,3,2520,0,98059
360000.0,4,2.5,2390,7115,2.0,3,2390,0,98092
390000.0,3,1.75,1320,7725,1.0,3,1320,0,98058
432900.0,3,2.5,2210,9226,2.0,3,2210,0,98045
621138.0,3,2.25,2180,7741,2.0,3,2180,0,98074
270000.0,3,2.25,2080,4252,1.5,3,1550,530,98042
610000.0,4,2.25,2090,35040,1.0,3,1490,600,98075
264000.0,3,1.5,1470,14821,1.0,4,1470,0,98042
550000.0,3,1.75,1650,3200,1.5,3,1650,0,98102
337000.0,3,2.0,1690,9087,1.0,3,1690,0,98042
775000.0,4,2.5,2540,28563,1.0,3,2540,0,98052
425000.0,3,2.25,1570,7475,1.0,4,1200,370,98034
409900.0,3,2.5,1690,1200,2.0,3,1410,280,98106
657500.0,4,1.75,1620,7560,1.0,4,1380,240,98117
391000.0,3,2.0,1490,9000,1.0,4,1490,0,98006
420000.0,4,2.5,2110,9825,2.0,3,2110,0,98059
350000.0,3,1.75,1830,9425,1.0,3,1590,240,98146
250000.0,4,2.25,1730,8400,1.0,3,1730,0,98001
365000.0,4,2.25,1990,21312,1.0,4,1990,0,98058
245000.0,3,2.0,1450,9333,2.0,4,1450,0,98003
265900.0,3,2.0,1180,7793,1.0,4,1180,0,98031
299000.0,4,2.5,1820,7575,1.0,3,1220,600,98058
307500.0,3,2.25,1646,7364,2.0,3,1646,0,98038
720000.0,3,1.5,1590,7080,1.0,3,1310,280,98136
434500.0,3,1.75,1650,7965,1.0,4,1650,0,98034
607010.0,4,2.5,2180,4000,2.0,3,1700,480,98118
294000.0,3,1.75,1530,9362,1.0,3,1530,0,98038
303000.0,3,2.5,1850,4957,2.0,3,1850,0,98092
605000.0,3,1.75,2330,6000,1.5,4,1630,700,98126
300000.0,3,1.5,1500,14750,1.5,4,1500,0,98168
443500.0,3,2.0,1920,7598,1.0,4,1920,0,98177
655000.0,3,2.5,2320,4721,2.0,3,2320,0,98075
372500.0,3,1.75,1550,12956,1.0,3,1210,340,98045
390000.0,3,1.75,1790,7123,1.0,3,1790,0,98019
895000.0,3,2.5,2500,7746,2.0,4,1910,590,98112
703770.0,4,2.25,2550,12918,2.0,3,2550,0,98006
249950.0,3,1.75,1320,10454,1.0,4,1320,0,98002
378000.0,4,2.5,1890,12236,1.0,3,1230,660,98045
537500.0,4,2.5,2550,4630,2.0,3,2550,0,98075
290000.0,3,2.0,1760,6600,1.0,3,1760,0,98030
349500.0,3,2.0,1270,3600,1.0,3,1270,0,98122
549500.0,3,1.75,1620,8438,1.0,4,1620,0,98125
550000.0,4,2.5,1670,5116,2.0,3,1670,0,98155
180500.0,3,1.5,1540,9800,1.0,3,1010,530,98058
540000.0,4,2.0,1990,29078,2.0,3,1990,0,98074
520000.0,3,1.75,2300,35722,1.0,3,2300,0,98072
177500.0,3,1.5,1220,6000,1.0,3,1220,0,98055
325000.0,3,2.25,1890,9646,1.0,3,1890,0,98168
411000.0,3,1.75,1490,9844,1.0,4,1190,300,98155
835100.0,4,2.5,2380,12573,1.0,4,2380,0,98005
450000.0,3,2.25,1780,9969,1.0,3,1450,330,98034
238000.0,3,2.5,1650,2807,2.0,3,1650,0,98055
340000.0,3,1.75,2190,12626,2.0,4,2190,0,98042
272750.0,4,1.5,1800,8786,1.0,3,1330,470,98146
520000.0,4,2.0,2000,6380,2.0,4,1860,140,98115
365000.0,3,1.5,1300,12240,1.0,3,1300,0,98028
425000.0,4,2.0,1330,9188,1.5,3,1330,0,98198
400000.0,4,1.75,1850,6480,1.0,4,1120,730,98108
335000.0,4,2.5,2240,9701,2.0,3,2240,0,98023
331500.0,4,1.75,1820,14319,1.0,4,1820,0,98059
220000.0,4,2.0,2340,10507,1.5,4,2340,0,98030
285000.0,4,2.25,1830,8734,2.0,4,1830,0,98030
224000.0,4,1.5,1600,9289,1.0,4,1600,0,98002
510000.0,3,2.25,2370,38639,1.0,3,1930,440,98077
390000.0,3,1.5,1610,13500,1.0,3,1060,550,98155
700000.0,3,1.75,2000,14733,1.0,4,2000,0,98005
470000.0,3,2.25,2220,9800,2.0,3,2220,0,98155
374000.0,3,1.75,2000,9416,1.0,4,2000,0,98033
576000.0,4,2.5,2440,28405,2.0,3,2440,0,98028
196440.0,3,2.0,1560,7352,1.0,3,1560,0,98001
340000.0,3,1.75,1740,46580,1.0,4,1740,0,98010
561000.0,3,2.0,2000,7000,2.0,3,2000,0,98136
270000.0,3,2.25,1520,7930,1.0,3,1160,360,98038
469000.0,3,2.25,1820,8446,2.0,3,1820,0,98034
365000.0,3,1.5,1640,8301,1.0,3,1290,350,98155
453000.0,3,2.5,1820,16300,1.0,4,1220,600,98166
187500.0,3,1.5,1180,7000,1.0,4,1180,0,98023
300000.0,3,1.75,1280,12776,1.0,4,1280,0,98031
338000.0,3,2.5,2470,4948,2.0,3,2470,0,98038
360400.0,3,2.5,1630,11592,2.0,3,1630,0,98011
300000.0,3,1.75,1830,51836,1.0,4,1430,400,98059
264000.0,3,1.75,1760,7482,1.0,4,1760,0,98023
435000.0,3,2.0,2660,16677,1.0,3,2210,450,98038
200000.0,3,1.5,2060,15837,1.5,3,2060,0,98055
445000.0,4,2.5,2340,3784,2.0,3,2340,0,98106
379500.0,3,2.25,2070,14196,2.0,3,2070,0,98059
372000.0,4,2.75,2610,8967,2.0,4,2610,0,98042
541100.0,4,2.25,2510,9800,2.0,3,2510,0,98072
600000.0,3,2.25,2240,9314,2.0,3,2240,0,98074
530000.0,4,2.25,2210,7665,2.0,4,2210,0,98006
390000.0,4,1.75,2330,8364,1.0,4,2330,0,98058
487250.0,4,2.0,1690,3250,1.5,3,1550,140,98103
299000.0,4,2.5,1950,3000,2.0,3,1950,0,98178
305000.0,4,2.5,2430,9103,2.0,3,2430,0,98023
327500.0,3,2.25,1770,8755,1.0,3,1330,440,98058
269000.0,3,2.0,1210,7136,1.0,3,1210,0,98031
443000.0,3,1.75,1530,8028,1.0,3,1200,330,98177
552500.0,3,1.75,2040,5775,1.0,3,1410,630,98199
341000.0,3,1.5,1720,7119,1.5,4,1720,0,98155
279000.0,4,2.25,2090,8941,2.0,3,2090,0,98058
686000.0,4,2.25,2130,10650,2.0,4,2130,0,98006
780000.0,3,2.5,2610,7567,2.0,3,2610,0,98052
580000.0,4,2.75,2330,6703,1.5,3,1710,620,98177
465000.0,4,2.5,2200,3141,2.0,3,2060,140,98144
206000.0,4,2.0,1720,7560,1.0,3,1720,0,98001
615000.0,3,2.5,2250,10171,2.0,3,2250,0,98006
240000.0,4,1.5,1920,7973,1.0,3,1920,0,98178
574000.0,3,2.0,2060,7000,1.0,4,2060,0,98029
415000.0,3,1.5,1490,7275,1.0,3,1090,400,98034
439000.0,4,2.25,2570,9503,2.0,3,2570,0,98011
477000.0,3,2.25,1260,3000,2.0,3,1260,0,98029
587500.0,4,2.25,1780,6120,1.0,3,1310,470,98115
453250.0,4,2.5,2260,6300,2.0,3,2260,0,98019
360000.0,3,2.25,2200,8000,2.0,3,2200,0,98055
550000.0,4,1.75,2030,5688,2.0,4,1730,300,98146
260000.0,3,1.75,1340,8000,1.0,3,1340,0,98038
249000.0,3,1.5,1580,7200,1.0,4,1080,500,98092
380000.0,3,2.0,1840,8580,1.0,3,1840,0,98058
520000.0,4,1.75,1240,4532,1.5,4,1240,0,98117
353500.0,4,2.25,1760,9602,2.0,3,1760,0,98058
386500.0,3,1.75,1520,7350,1.0,4,1140,380,98034
339000.0,4,2.5,1830,8601,2.0,3,1830,0,98038
625000.0,3,2.0,2140,3600,2.0,3,1680,460,98116
207000.0,4,2.5,2100,19680,1.5,3,2100,0,98055
370000.0,4,2.5,2100,19680,1.5,3,2100,0,98055
475000.0,3,2.5,1460,4961,1.0,4,1150,310,98033
618000.0,3,2.5,2340,3630,2.0,3,2340,0,98122
616300.0,3,2.0,1700,8400,2.0,3,1700,0,98033
348000.0,3,1.5,1330,6768,1.0,4,1330,0,98155
425000.0,3,2.5,1630,10762,1.0,3,1630,0,98011
835000.0,3,1.75,1490,3840,2.0,3,1490,0,98033
350000.0,3,2.5,1630,3425,2.0,3,1630,0,98059
349000.0,4,2.5,2280,4096,2.0,3,2280,0,98056
320000.0,3,2.5,1590,3480,2.0,3,1590,0,98056
580000.0,3,2.5,2200,11000,2.0,3,2200,0,98008
550000.0,3,2.25,2160,37000,1.5,4,1760,400,98052
755000.0,4,2.5,2120,10202,1.0,4,1620,500,98005
470000.0,4,2.5,1850,11250,1.5,3,1210,640,98074
439950.0,4,2.5,2380,12067,2.0,3,2380,0,98059
325000.0,3,1.75,2250,26337,1.0,3,2250,0,98092
339950.0,3,2.0,1340,10200,1.5,3,1340,0,98133
315000.0,3,1.75,1660,8160,1.0,4,1660,0,98166
411753.0,3,2.5,1710,3795,2.0,3,1710,0,98053
210000.0,3,2.0,1440,10111,1.0,3,1440,0,98001
640000.0,4,1.75,2020,16120,1.0,3,2020,0,98010
467000.0,3,2.5,1530,3984,2.0,3,1530,0,98029
316500.0,3,1.75,1460,6360,1.0,3,1010,450,98106
490000.0,3,2.0,1450,2400,1.5,3,1450,0,98107
378000.0,4,1.75,1990,23200,1.0,4,1990,0,98059
335000.0,3,1.5,1560,9600,1.0,4,1560,0,98033
550000.0,3,2.5,2260,4165,2.0,3,2260,0,98075
275000.0,3,1.75,1490,8000,1.0,3,1490,0,98030
284200.0,3,2.5,1570,9292,1.0,3,1110,460,98001
215000.0,4,1.5,1430,8775,1.0,3,1030,400,98023
347000.0,3,1.75,1240,8050,1.0,4,1240,0,98074
232500.0,3,2.0,1370,9760,1.0,4,1110,260,98023
390000.0,4,2.25,1770,33132,1.0,4,1190,580,98058
590000.0,4,2.5,2340,8971,2.0,3,2340,0,98029
429800.0,3,2.0,1970,7000,1.0,3,1970,0,98038
302000.0,4,1.75,1530,17664,1.5,3,1530,0,98058
800000.0,4,1.5,1790,3952,1.5,4,1790,0,98103
250000.0,3,2.5,1700,6000,2.0,3,1700,0,98092
412000.0,3,1.75,1950,52256,1.0,4,1950,0,98042
252000.0,3,2.0,1340,5670,2.0,3,1340,0,98055
780000.0,4,2.25,2260,16188,1.0,3,2260,0,98006
695000.0,3,2.5,2390,4555,2.0,3,2390,0,98074
562500.0,4,2.5,2440,7322,2.0,3,2440,0,98056
402500.0,4,2.5,2600,11951,2.0,3,2600,0,98023
335000.0,4,2.5,2330,7050,2.0,3,2330,0,98178
299000.0,3,1.75,1730,14270,1.0,3,1730,0,98065
722500.0,4,2.5,2460,9296,2.0,3,2460,0,98007
280000.0,3,2.5,1650,6000,2.0,3,1650,0,98030
176250.0,4,2.0,1440,6702,1.0,4,1440,0,98002
625000.0,3,1.75,1660,4800,2.0,3,1660,0,98112
272000.0,3,2.0,1380,7476,1.0,3,1380,0,98001
352000.0,4,2.5,2470,5015,2.0,3,2470,0,98038
340000.0,4,2.5,2380,7850,2.0,3,2380,0,98055
380000.0,4,1.75,1740,9150,1.0,3,1740,0,98188
505000.0,3,2.5,2100,17882,2.0,4,2100,0,98059
464900.0,4,2.25,2020,8424,1.0,4,1380,640,98034
650000.0,3,2.0,2520,5980,1.0,3,1790,730,98116
250000.0,3,2.5,1530,2890,2.0,3,1530,0,98108
320000.0,3,2.5,1530,2890,2.0,3,1530,0,98108
340000.0,4,2.25,2530,24700,2.0,3,2530,0,98031
528000.0,4,1.75,1860,9750,1.0,3,1460,400,98034
545000.0,4,1.75,1940,8990,1.0,4,1560,380,98034
235000.0,4,2.75,1770,10184,1.0,3,1250,520,98023
272000.0,3,2.5,1790,6371,2.0,3,1790,0,98092
380000.0,4,1.75,1720,9600,1.0,4,1720,0,98059
297000.0,3,2.5,1690,4988,2.0,3,1690,0,98038
349000.0,4,2.5,2190,7294,2.0,3,2190,0,98023
319990.0,4,1.5,1890,10707,1.0,3,1890,0,98148
272500.0,3,2.0,1540,6250,1.0,3,1540,0,98038
400000.0,4,2.0,1350,7255,1.0,4,1350,0,98125
550000.0,3,2.5,1900,3255,2.0,3,1900,0,98007
460000.0,3,2.5,1730,8490,1.0,3,1210,520,98034
632500.0,4,2.5,2090,10306,2.0,3,2090,0,98074
361000.0,3,1.75,1650,11220,1.0,4,1650,0,98077
715000.0,3,2.5,2410,46609,2.0,3,2410,0,98053
545000.0,4,1.5,1370,3708,1.5,3,1370,0,98117
295000.0,3,2.5,1460,7936,2.0,3,1460,0,98038
502000.0,4,1.5,1700,8400,1.0,3,1700,0,98177
491000.0,3,2.0,2005,7000,1.0,3,1605,400,98122
310000.0,3,2.5,1990,3600,2.0,3,1990,0,98038
310000.0,3,1.75,1420,7650,1.0,4,1100,320,98056
272000.0,4,2.5,1870,5692,2.0,3,1870,0,98058
307000.0,3,2.0,1790,7259,1.0,3,1390,400,98058
491500.0,4,2.75,2100,7236,1.0,3,1400,700,98034
345000.0,3,2.25,2120,15003,2.0,3,2120,0,98059
339900.0,4,1.75,2600,18042,1.0,4,2020,580,98092
180500.0,3,2.5,1800,8518,2.0,3,1800,0,98030
325000.0,3,2.5,1800,8518,2.0,3,1800,0,98030
235000.0,3,1.75,1190,7280,1.0,4,1190,0,98092
463000.0,4,2.5,1980,6660,2.0,4,1980,0,98034
655000.0,3,2.0,1410,4800,1.5,4,1410,0,98118
251700.0,3,2.25,1810,11800,1.0,3,1240,570,98178
400000.0,4,2.0,1560,8250,1.0,3,1320,240,98177
292500.0,4,1.75,2140,8162,1.0,3,1420,720,98023
270000.0,3,2.25,2390,7000,1.0,4,1990,400,98058
353000.0,3,2.75,2170,8396,2.0,3,2170,0,98038
585000.0,3,1.75,1850,7735,1.0,4,1850,0,98027
605000.0,3,1.75,1850,8823,1.0,4,1370,480,98008
550000.0,3,2.5,2250,7752,2.0,4,2250,0,98011
665000.0,3,1.75,1800,8000,1.0,3,1800,0,98008
332000.0,3,2.25,2120,14915,1.0,3,1720,400,98001
280000.0,3,2.5,1860,6607,2.0,3,1860,0,98023
346300.0,4,2.5,2590,11018,2.0,3,2590,0,98092
342500.0,3,2.0,2080,11375,1.0,3,2080,0,98022
270000.0,3,2.5,1670,8364,1.0,4,1300,370,98042
333000.0,4,2.5,2400,7270,2.0,3,2400,0,98003
330000.0,3,2.5,1680,11312,1.0,3,1080,600,98146
360000.0,4,2.0,1850,8827,1.0,3,1850,0,98155
490000.0,3,1.75,1720,12540,1.0,4,1720,0,98006
399000.0,3,2.25,1880,12473,1.0,3,1420,460,98028
340000.0,4,2.5,2360,7475,2.0,3,2360,0,98031
612000.0,3,2.5,2180,5496,2.0,3,2180,0,98029
604000.0,4,2.5,2260,7753,2.0,3,2260,0,98029
250000.0,3,1.75,1770,8868,1.0,4,1770,0,98002
258500.0,3,2.0,1460,7930,1.0,3,1460,0,98038
550000.0,4,2.0,1660,12377,1.0,3,1660,0,98008
257000.0,3,1.75,1850,10920,1.5,3,1850,0,98034
235000.0,4,2.0,1570,9415,2.0,4,1570,0,98092
275000.0,3,2.5,1600,7000,2.0,4,1600,0,98038
465000.0,3,1.75,1490,10757,1.0,3,1060,430,98034
265000.0,4,2.5,2040,4443,2.0,3,2040,0,98092
529219.0,4,2.25,1990,7610,1.0,4,1290,700,98008
600000.0,3,2.25,1900,46609,1.5,4,1440,460,98072
295450.0,3,2.0,2030,17120,1.0,4,1890,140,98092
205000.0,4,2.0,1450,8175,1.0,4,1450,0,98031
310000.0,3,1.5,1460,9908,1.0,3,1460,0,98148
510000.0,3,1.75,2170,26460,1.0,3,1450,720,98074
509950.0,3,2.5,1970,9153,2.0,3,1970,0,98028
600000.0,4,2.25,2090,45738,2.0,3,2090,0,98053
515000.0,3,1.75,1600,20873,1.0,3,1600,0,98006
245000.0,4,2.0,1870,8750,1.0,3,1870,0,98022
265000.0,3,2.5,1440,7741,1.0,4,1000,440,98031
270000.0,4,2.5,1750,6397,2.0,3,1750,0,98023
213550.0,3,2.5,1580,8541,2.0,3,1580,0,98001
235000.0,3,1.5,1300,7600,1.0,4,1300,0,98022
546800.0,4,1.5,1520,5910,1.0,3,1020,500,98115
610000.0,4,2.25,1660,7350,1.0,3,1660,0,98008
288350.0,3,1.5,1860,7963,1.0,3,1200,660,98188
775000.0,4,2.5,2300,6158,2.0,3,2300,0,98115
429500.0,3,2.75,1650,7272,1.0,4,1230,420,98034
225000.0,3,1.5,1310,10491,1.0,4,1310,0,98042
354950.0,3,1.75,1780,9689,1.0,3,1130,650,98072
522250.0,4,2.5,2340,41600,1.0,3,1640,700,98077
275000.0,3,2.5,1720,8755,1.0,3,1000,720,98023
390000.0,3,1.5,1600,10440,1.0,3,1600,0,98125
260000.0,3,1.5,1320,9750,1.0,3,1320,0,98148
342000.0,4,2.5,2300,6448,2.0,3,2300,0,98030
252000.0,3,1.75,1430,7700,1.0,4,980,450,98031
357000.0,3,1.75,2400,14012,1.0,3,2400,0,98003
369160.0,4,2.25,2120,9680,2.0,4,2120,0,98003
471000.0,3,2.5,2010,4059,2.0,3,2010,0,98034
450000.0,3,1.5,1770,17208,1.0,3,1160,610,98006
270000.0,4,2.0,1830,5220,1.5,3,1830,0,98118
226740.0,3,1.5,1410,8800,1.0,4,1410,0,98092
283000.0,3,2.0,1820,15068,2.0,3,1520,300,98022
445000.0,4,1.75,2430,13211,1.5,4,2430,0,98024
315000.0,4,2.75,2200,8580,1.0,3,1860,340,98023
510000.0,3,2.0,1600,4510,1.0,3,990,610,98103
328000.0,4,2.5,1990,3980,2.0,3,1990,0,98058
358000.0,4,2.5,1830,7308,2.0,3,1830,0,98038
325000.0,3,2.5,2540,4260,2.0,3,2540,0,98042
230000.0,4,2.0,1440,10800,1.0,4,1440,0,98001
705380.0,3,2.5,2490,4343,2.0,3,2490,0,98029
815000.0,4,2.25,2000,3800,2.0,3,2000,0,98115
255000.0,4,2.5,2070,7800,2.0,3,2070,0,98003
232000.0,3,2.0,1280,13356,1.0,3,1280,0,98042
262000.0,4,2.5,2020,6236,2.0,3,2020,0,98001
674750.0,4,2.5,2590,9753,2.0,3,2590,0,98075
575000.0,4,2.5,2520,35636,2.0,3,2520,0,98053
469000.0,3,2.25,2070,9957,1.0,3,1440,630,98155
363000.0,3,2.0,1750,7000,1.0,3,1750,0,98038
282000.0,3,2.25,1552,3600,2.0,3,1552,0,98092
269950.0,4,2.5,1960,7230,2.0,3,1960,0,98023
193000.0,3,1.5,1180,7000,1.0,4,1180,0,98023
340000.0,4,2.25,2230,6791,2.0,3,2230,0,98038
371000.0,3,2.5,2150,8361,2.0,3,2150,0,98058
300000.0,3,2.5,1830,12750,2.0,3,1830,0,98168
299500.0,3,2.5,2090,7163,2.0,3,2090,0,98003
335000.0,4,1.75,1670,9472,1.0,3,1100,570,98106
450000.0,3,1.75,1610,11200,1.0,3,1610,0,98033
322500.0,4,2.5,1940,7107,2.0,3,1940,0,98038
655000.0,4,2.5,2570,4412,2.0,3,2570,0,98034
435000.0,4,2.25,1990,8548,2.0,3,1990,0,98033
242000.0,3,2.0,1260,8092,1.0,3,1260,0,98038
280000.0,3,1.75,1590,7280,1.0,3,1140,450,98058
580000.0,4,2.5,2220,7064,2.0,3,2220,0,98029
525000.0,4,2.5,2303,16801,2.0,3,2303,0,98019
562000.0,3,1.75,1600,10530,1.0,3,1600,0,98155
335000.0,3,2.5,1700,6698,2.0,3,1700,0,98038
490000.0,3,1.75,1540,9000,1.0,3,1540,0,98125
445000.0,4,2.5,2280,42077,2.0,3,2280,0,98042
355000.0,3,2.25,2550,9674,1.0,3,1850,700,98178
737500.0,3,1.75,2320,10900,2.0,3,2320,0,98115
306000.0,4,2.5,2490,8124,2.0,3,2490,0,98092
381000.0,3,2.5,1470,3999,2.0,3,1470,0,98065
703000.0,3,2.0,1360,5980,1.5,3,1360,0,98116
262000.0,3,1.75,1320,6530,1.0,4,1320,0,98023
353000.0,3,2.0,1210,14499,1.0,3,1210,0,98045
500000.0,4,2.5,1940,7607,2.0,3,1940,0,98052
332000.0,4,2.5,1980,6566,2.0,3,1980,0,98042
824000.0,4,2.5,2320,14240,1.0,4,1620,700,98008
290000.0,4,2.0,1660,4788,1.0,3,1660,0,98144
700000.0,3,2.5,1660,1545,2.0,3,1400,260,98109
679000.0,4,1.5,1420,4923,1.5,4,1420,0,98103
543000.0,4,2.5,2060,8451,2.0,3,2060,0,98133
340500.0,3,1.75,1810,10463,1.0,4,1810,0,98058
425000.0,3,2.0,1540,8011,1.0,3,1540,0,98011
353000.0,3,2.5,2510,9240,2.0,4,2510,0,98022
540000.0,3,2.5,1670,5146,2.0,3,1670,0,98029
660000.0,4,1.75,1870,10450,1.0,3,1620,250,98005
195000.0,3,1.5,1190,8726,1.0,3,1190,0,98146
560000.0,4,1.75,2150,8555,1.0,4,1460,690,98106
475000.0,3,2.5,2370,3239,2.0,3,1950,420,98072
650000.0,3,2.5,2190,3600,2.0,3,2190,0,98029
620000.0,3,2.25,1660,3478,1.5,4,1100,560,98117
526000.0,3,1.75,1780,37801,1.0,3,1300,480,98075
342000.0,4,2.0,1570,11200,1.0,3,1120,450,98011
462000.0,3,1.5,1710,4500,1.5,3,1410,300,98118
545000.0,4,2.5,2090,6023,2.0,3,2090,0,98029
269000.0,3,2.5,1560,4200,2.0,3,1560,0,98038
356500.0,4,2.5,2570,11473,2.0,3,2570,0,98003
535000.0,3,2.75,2300,12197,2.0,3,2300,0,98166
340000.0,3,2.5,1400,4800,1.0,3,1200,200,98117
537000.0,3,2.5,1400,4800,1.0,3,1200,200,98117
661000.0,4,2.5,2496,8058,2.0,3,2496,0,98052
419950.0,3,2.25,2280,8500,1.0,4,1680,600,98034
552500.0,3,2.5,2450,3582,2.0,3,2450,0,98072
390000.0,3,2.5,2480,53250,2.0,3,2480,0,98042
465000.0,3,2.5,1440,4473,2.0,3,1440,0,98053
299900.0,4,2.5,1580,3632,2.0,3,1580,0,98038
235000.0,4,2.5,1810,39639,1.0,3,1230,580,98042
276000.0,3,2.5,2495,4400,2.0,3,2495,0,98001
265000.0,4,1.5,1740,12728,1.0,4,1180,560,98003
313000.0,4,2.5,2460,10320,2.0,3,2460,0,98092
265000.0,3,2.25,1630,10969,2.0,3,1630,0,98001
646000.0,3,2.75,2460,6413,2.0,3,2460,0,98028
493000.0,3,2.25,1790,11393,1.0,3,1790,0,98052
275000.0,3,2.5,1480,15639,2.0,3,1480,0,98045
455000.0,3,2.25,1470,4653,2.0,4,1470,0,98029
630000.0,3,1.75,1540,6930,1.0,3,1250,290,98115
212000.0,4,1.75,1250,12705,1.0,4,1250,0,98023
675000.0,3,1.75,1710,5913,1.0,4,1120,590,98199
387000.0,3,1.5,1340,6500,1.0,3,1340,0,98034
347500.0,4,2.75,2290,7000,2.0,3,2290,0,98058
375000.0,3,1.75,1440,8775,1.0,3,1440,0,98034
620000.0,4,2.5,2580,7465,2.0,3,2580,0,98074
565000.0,3,2.5,1880,12368,1.0,4,1260,620,98005
399500.0,3,1.75,2420,12676,2.0,3,2420,0,98045
352500.0,3,2.0,1920,33630,1.0,3,1920,0,98056
259000.0,3,2.0,1870,5909,1.0,3,1270,600,98030
733000.0,3,2.5,2160,9888,2.0,4,2160,0,98052
561000.0,4,2.5,2570,5250,2.0,3,2570,0,98029
540000.0,4,2.5,1850,7850,2.0,3,1850,0,98052
379000.0,3,2.5,1740,30886,2.0,3,1740,0,98045
399950.0,3,2.5,2000,30605,2.0,4,2000,0,98042
580000.0,4,2.25,2160,9593,1.0,3,2160,0,98008
700000.0,3,2.0,2130,4299,1.5,4,1680,450,98144
279900.0,3,1.75,1580,8151,1.0,4,1100,480,98198
606000.0,4,2.5,2110,13850,2.0,3,2110,0,98027
677100.0,3,2.0,2110,9199,1.0,3,2110,0,98074
465000.0,3,2.0,1430,7125,1.0,4,1430,0,98074
420000.0,3,2.5,2060,7020,1.0,4,1460,600,98177
257500.0,3,1.75,1530,14087,1.0,3,1070,460,98042
536000.0,3,1.75,1580,3764,1.5,3,1280,300,98107
246500.0,3,1.5,1270,11600,1.0,4,1270,0,98031
395000.0,3,1.75,1480,7700,1.0,3,1480,0,98034
739000.0,3,2.25,2220,10530,1.0,4,1700,520,98052
305000.0,3,1.5,1480,9086,1.0,3,1480,0,98168
656000.0,3,1.75,1480,7475,1.5,3,1480,0,98115
259000.0,3,2.5,2153,4400,2.0,3,2153,0,98001
500000.0,4,2.5,2040,8400,1.0,3,1420,620,98006
202500.0,3,1.5,1510,9898,1.0,3,1110,400,98148
225000.0,3,2.5,1740,10050,2.0,3,1740,0,98001
356500.0,4,1.75,1570,9670,1.0,3,1170,400,98028
689000.0,4,2.5,2240,7350,2.0,3,2240,0,98029
271900.0,3,1.75,1890,11875,1.0,3,1230,660,98045
278000.0,4,2.5,1850,6037,2.0,3,1850,0,98030
399500.0,3,1.75,1410,7700,1.0,4,1410,0,98056
462000.0,3,2.75,1890,2614,2.0,4,1890,0,98008
312000.0,4,2.0,1300,7054,1.0,3,1300,0,98146
415000.0,4,2.25,2240,12650,1.0,4,1730,510,98059
369990.0,4,2.5,1960,7133,2.0,3,1960,0,98056
349950.0,4,2.5,1820,3134,2.0,3,1820,0,98019
285750.0,3,2.25,1960,17126,1.0,3,1400,560,98055
542500.0,4,2.25,1750,10160,1.0,3,1320,430,98005
705000.0,4,2.5,2910,20946,2.0,4,2350,560,98034
250000.0,3,1.5,2210,11111,1.5,3,2210,0,98168
305000.0,3,2.5,1714,3240,2.0,3,1714,0,98055
273000.0,3,1.75,2050,9045,2.0,4,2050,0,98058
354450.0,4,2.75,2140,9920,2.0,3,2140,0,98001
410000.0,3,2.5,1740,4948,2.0,3,1740,0,98053
298500.0,4,2.5,1890,5954,2.0,3,1890,0,98092
700000.0,4,1.75,2340,9100,1.0,3,1610,730,98052
374150.0,3,1.75,1390,9585,1.0,4,1390,0,98133
397000.0,4,2.5,2201,9542,2.0,3,2201,0,98198
613000.0,3,2.25,1960,10385,1.0,3,1960,0,98008
388000.0,4,2.5,2560,5800,2.0,3,2560,0,98038
404000.0,3,1.75,1410,15210,1.0,3,1410,0,98166
266000.0,3,2.5,1780,7214,1.0,4,1400,380,98030
352000.0,4,2.5,1252,25002,1.0,3,992,260,98001
265000.0,4,1.5,1240,8158,1.0,4,1110,130,98198
856000.0,3,2.5,2160,3920,2.0,3,2160,0,98116
346950.0,3,2.5,2040,4348,2.0,4,2040,0,98038
410000.0,3,2.5,2350,4456,2.0,3,2350,0,98065
370000.0,3,1.75,1570,16817,2.0,3,1570,0,98045
615000.0,3,1.75,1950,8480,1.0,4,1250,700,98007
385000.0,3,1.75,1300,7030,1.0,3,1300,0,98034
420000.0,4,2.25,2030,12000,2.0,3,2030,0,98011
549950.0,3,2.5,2160,6288,2.0,3,2160,0,98133
199000.0,4,2.0,2030,8120,2.0,3,2030,0,98178
509250.0,3,2.5,2100,7600,1.0,4,1450,650,98052
416000.0,3,2.5,1800,5372,2.0,3,1800,0,98034
325900.0,3,2.5,2040,9765,2.0,3,2040,0,98023
275000.0,3,2.5,1730,5799,2.0,4,1730,0,98030
665000.0,4,2.5,2480,15411,2.0,3,2480,0,98059
359950.0,3,1.75,1570,6975,1.0,3,1040,530,98126
638500.0,4,2.5,1980,6568,2.0,3,1980,0,98052
828000.0,4,2.5,2120,10841,1.0,4,1500,620,98006
223000.0,3,1.75,1360,10573,1.0,4,1360,0,98023
310000.0,4,2.5,1930,7014,2.0,3,1930,0,98042
274900.0,4,2.5,1970,6600,2.0,3,1970,0,98030
195000.0,3,1.75,1380,7350,1.0,3,990,390,98042
330000.0,4,1.75,1520,14417,1.0,4,1520,0,98065
503000.0,3,2.5,2190,4882,2.0,3,2190,0,98155
459950.0,3,2.5,2340,4273,2.0,3,2340,0,98065
425000.0,3,2.0,1180,1800,2.0,3,1180,0,98122
460000.0,3,2.25,2080,50965,1.0,3,1590,490,98077
250250.0,3,2.25,2210,8000,2.0,4,2210,0,98023
450000.0,4,1.75,1980,7350,1.0,3,1430,550,98034
490000.0,3,1.75,1600,16510,1.0,3,1600,0,98052
375000.0,3,1.75,1430,10574,2.0,3,1430,0,98011
306000.0,3,1.75,1560,7500,1.0,4,1560,0,98056
341000.0,4,1.75,1920,7665,1.0,4,1500,420,98058
399950.0,3,2.5,1400,4400,1.0,3,1400,0,98106
856000.0,3,1.5,1480,2700,1.5,3,1480,0,98112
423700.0,3,2.5,2070,3986,2.0,3,2070,0,98065
322000.0,3,2.0,1760,43575,1.0,3,1160,600,98010
441500.0,3,1.75,1510,7700,1.0,3,1510,0,98034
425000.0,3,2.25,1630,10500,1.0,3,1100,530,98034
499000.0,4,2.75,2250,14149,2.0,3,2250,0,98019
521000.0,3,1.75,1720,37363,1.0,4,1350,370,98053
293000.0,4,2.25,2360,6260,2.0,3,2360,0,98038
335000.0,3,2.25,1530,4580,2.0,3,1530,0,98019
600000.0,3,1.75,2040,5000,1.5,3,1780,260,98115
334000.0,3,2.25,1840,9781,2.0,3,1840,0,98019
700000.0,4,1.75,1730,6500,1.0,3,1250,480,98115
525000.0,4,1.5,1170,6240,1.0,4,1170,0,98040
402000.0,3,2.5,1960,8000,1.0,4,1290,670,98034
450000.0,3,2.0,1430,3480,1.0,3,980,450,98103
520000.0,3,2.25,2510,43995,2.0,3,2510,0,98027
350000.0,3,1.75,1580,19998,1.0,4,1580,0,98010
435000.0,4,2.0,2030,4033,2.0,4,1630,400,98133
355000.0,3,1.5,1240,15867,1.0,3,1240,0,98034
305000.0,4,2.25,2130,9600,1.0,4,2130,0,98031
675000.0,3,2.5,2550,4954,1.5,4,1850,700,98144
476000.0,3,2.25,1570,7187,1.0,4,1170,400,98133
510000.0,3,1.75,1600,19200,1.0,4,1600,0,98034
455000.0,3,1.75,1300,9600,1.0,4,1300,0,98052
372000.0,4,1.5,1780,7914,1.5,4,1780,0,98059
570000.0,3,2.5,1910,4941,2.0,3,1910,0,98075
265000.0,3,2.0,1380,8536,2.0,4,1380,0,98148
500000.0,4,2.25,2080,8000,1.0,3,1390,690,98008
380000.0,4,2.5,2100,5857,2.0,3,2100,0,98059
315000.0,3,1.5,1750,12500,1.0,3,1150,600,98024
254600.0,3,2.0,1470,20000,1.0,4,1470,0,98002
550000.0,4,2.5,2170,9600,1.0,3,1460,710,98052
275436.0,4,2.75,2170,9658,1.5,3,2170,0,98030
635000.0,4,2.5,2490,40608,2.0,3,2490,0,98053
513000.0,3,1.75,1710,5000,1.0,4,1110,600,98107
580000.0,4,2.5,2130,35752,1.0,3,1490,640,98075
655500.0,4,2.75,2380,15800,1.0,3,1680,700,98007
438000.0,4,2.5,1970,8545,2.0,3,1970,0,98059
590000.0,3,2.75,2550,54014,2.0,4,1980,570,98072
650000.0,3,1.5,1630,7475,1.0,3,1160,470,98115
220000.0,4,1.75,1660,11664,1.0,3,1010,650,98168
483000.0,3,1.75,2110,10454,1.0,4,1440,670,98028
435000.0,3,2.5,1900,7984,2.0,3,1900,0,98011
299950.0,3,2.5,1870,7942,2.0,3,1870,0,98001
802000.0,4,2.25,2130,8734,2.0,4,2130,0,98006
392000.0,4,2.5,2300,41167,2.0,3,2300,0,98042
313500.0,3,2.25,1440,3488,2.0,4,1440,0,98034
604000.0,4,1.75,1490,4485,1.0,3,1350,140,98199
570000.0,3,2.0,1400,1657,2.0,3,1060,340,98112
639000.0,4,2.5,2150,12028,2.0,4,2150,0,98052
335000.0,4,2.0,1910,10200,1.0,4,1910,0,98059
896000.0,4,1.75,2660,3520,2.0,4,2080,580,98115
259500.0,3,1.75,1650,12349,1.0,3,1650,0,98188
637000.0,3,2.0,1980,6000,1.0,4,1380,600,98115
259000.0,3,1.75,1590,7148,1.0,3,1590,0,98166
228800.0,4,2.5,1470,1612,2.0,3,980,490,98118
449000.0,4,2.5,1850,5040,1.0,3,1230,620,98126
502000.0,3,2.75,2010,11200,1.0,3,1360,650,98028
453000.0,3,2.0,1660,15050,1.0,3,1260,400,98034
550000.0,3,2.5,2510,5400,2.0,3,2510,0,98056
273500.0,3,1.5,1560,8314,1.0,3,1560,0,98031
565000.0,4,2.25,2470,7447,2.0,3,2470,0,98155
445000.0,4,2.5,2170,5257,2.0,3,2170,0,98115
525000.0,3,2.5,2200,4544,2.0,3,2200,0,98065
439000.0,3,1.75,1250,7030,1.0,3,1250,0,98008
716000.0,3,2.5,2270,7866,1.0,4,2270,0,98029
800000.0,3,2.25,1620,4500,2.0,4,1620,0,98119
219950.0,3,1.5,1620,9310,1.0,4,1620,0,98042
770000.0,4,2.5,2350,8001,2.0,4,2350,0,98006
424950.0,3,1.75,2090,7505,1.0,3,2090,0,98034
387000.0,3,2.25,1760,45133,2.0,3,1760,0,98065
790000.0,4,1.75,2050,10920,1.0,3,1450,600,98155
490000.0,4,2.25,2090,10869,2.0,3,2090,0,98033
365000.0,4,2.5,2540,6688,2.0,3,2540,0,98092
255000.0,3,1.75,2190,6000,1.5,4,2190,0,98002
728000.0,3,1.5,1940,4000,1.5,3,1310,630,98112
370000.0,4,2.0,1640,7200,1.0,3,1640,0,98155
275000.0,4,2.0,2030,8426,2.0,3,2030,0,98168
280000.0,3,2.5,1270,9675,2.0,3,1270,0,98045
325000.0,4,2.5,2260,5702,2.0,3,2260,0,98042
495000.0,3,2.5,1780,47480,2.0,3,1780,0,98045
348000.0,3,2.5,2060,7458,2.0,3,2060,0,98023
200000.0,4,2.5,1720,9600,1.0,3,1120,600,98092
247500.0,3,2.0,1530,8749,1.0,3,1530,0,98023
283200.0,4,1.75,1830,12540,1.0,4,1130,700,98003
650000.0,3,2.5,2540,8073,1.0,4,1880,660,98177
400000.0,3,1.75,1470,6682,1.0,3,1470,0,98034
483500.0,3,2.5,1670,4308,2.0,3,1670,0,98027
387000.0,3,1.5,1620,21929,2.0,3,1620,0,98019
336000.0,3,1.5,1240,5000,1.0,3,1240,0,98106
350000.0,3,1.5,1320,4400,1.0,3,1320,0,98112
640000.0,3,2.0,1470,4640,1.5,4,1470,0,98199
390000.0,3,2.5,1910,4755,2.0,3,1910,0,98059
325000.0,4,1.75,1370,9993,1.0,3,1370,0,98028
181100.0,4,1.75,1850,7500,1.0,3,1850,0,98198
781000.0,3,1.75,1940,8729,1.0,3,1460,480,98125
426000.0,3,1.5,1380,7200,1.0,3,1080,300,98106
389000.0,3,2.5,1720,4515,2.0,3,1720,0,98065
288400.0,3,2.25,1870,3230,2.0,3,1870,0,98056
431000.0,3,1.75,1630,9000,1.0,4,1630,0,98166
485000.0,3,2.5,1840,8250,1.0,3,1340,500,98177
780000.0,3,1.5,1620,7500,1.0,4,1620,0,98117
316000.0,3,2.5,2550,8170,2.0,3,2550,0,98023
590000.0,3,2.25,2300,12430,1.0,4,1580,720,98166
364000.0,4,2.25,1750,10270,1.5,4,1750,0,98155
490000.0,3,2.5,1890,10190,2.0,3,1890,0,98074
410000.0,3,2.25,1800,36704,1.0,4,1360,440,98027
520000.0,3,2.5,2160,4297,2.0,3,2160,0,98029
325000.0,3,2.5,2550,4240,2.0,3,2550,0,98031
850000.0,3,2.25,2870,8170,2.0,3,2250,620,98136
285000.0,3,2.5,1940,9874,2.0,3,1940,0,98042
440000.0,3,2.0,1550,2401,2.0,3,1550,0,98103
635000.0,3,1.75,1210,4400,1.5,4,1210,0,98105
555000.0,3,1.5,1740,4200,1.5,4,1640,100,98117
315000.0,3,1.75,1480,7500,1.0,4,1480,0,98055
442000.0,4,1.5,1360,6110,1.0,3,1010,350,98116
375000.0,3,1.75,1370,19550,1.0,3,1370,0,98014
637250.0,4,2.5,2120,3220,2.0,3,2120,0,98052
680000.0,3,1.75,1660,5750,1.0,4,1080,580,98116
555565.0,3,2.0,1670,11337,1.0,4,1670,0,98033
650000.0,3,1.75,1660,10819,1.0,4,1240,420,98177
269000.0,3,2.5,1440,3800,2.0,3,1440,0,98038
638000.0,4,1.75,1470,4236,1.5,4,1470,0,98107
290000.0,3,1.75,1710,10950,1.0,3,1060,650,98045
270000.0,4,2.5,2350,5835,2.0,3,2350,0,98042
875000.0,4,2.25,2380,4876,2.0,4,2240,140,98117
299000.0,3,2.25,1920,7840,2.0,4,1920,0,98032
210000.0,3,2.25,1430,9150,1.0,3,1070,360,98023
350000.0,3,2.75,1650,5700,2.0,4,1650,0,98166
491500.0,3,2.25,1560,12000,1.0,4,1110,450,98034
325000.0,3,2.5,1870,9825,1.0,4,1250,620,98045
190000.0,3,2.0,1320,7625,1.0,3,1320,0,98038
658600.0,4,2.0,1400,4690,1.5,4,1400,0,98117
299950.0,3,1.5,1940,8951,1.0,3,1300,640,98168
240000.0,3,1.75,1630,9450,1.0,4,1080,550,98032
418000.0,3,1.75,1530,7238,1.0,3,1530,0,98155
580000.0,3,2.5,2180,40278,2.0,3,2180,0,98072
691500.0,4,2.5,2600,7200,2.0,3,2600,0,98115
556000.0,3,1.75,1590,2500,1.5,4,1190,400,98105
218000.0,3,2.25,1610,7084,1.0,4,1280,330,98023
732000.0,4,1.75,2360,11300,1.0,4,2360,0,98006
507250.0,3,1.75,1400,5750,1.0,3,1100,300,98126
600000.0,3,2.25,2100,8276,2.0,4,2100,0,98008
627800.0,4,1.75,2010,12044,1.0,3,2010,0,98074
456500.0,3,2.25,2090,9163,1.0,3,1460,630,98034
180000.0,3,1.75,1330,16000,1.0,3,1330,0,98001
193000.0,3,1.5,1180,9048,1.0,3,1180,0,98148
295000.0,4,2.5,1850,6663,2.0,3,1850,0,98030
257200.0,3,2.0,1850,8250,1.0,4,1150,700,98002
555000.0,3,2.0,2240,11250,1.0,3,2240,0,98008
380000.0,3,2.25,1860,15559,2.0,4,1860,0,98022
282000.0,4,2.75,2390,7330,2.0,3,2390,0,98023
545000.0,4,2.5,2040,6034,2.0,3,2040,0,98115
550000.0,3,1.5,1900,5000,1.5,3,1640,260,98115
820000.0,4,2.25,2280,6660,1.5,3,1960,320,98119
491950.0,3,2.25,2090,10733,1.0,3,1440,650,98115
430000.0,3,2.5,2030,7770,2.0,3,2030,0,98024
208000.0,3,2.0,1250,7995,1.0,4,1250,0,98042
400000.0,3,2.5,2120,3742,2.0,3,2120,0,98059
428000.0,3,2.5,2230,32660,1.0,4,2230,0,98042
410000.0,3,1.75,1880,8424,1.0,4,1380,500,98059
445000.0,3,2.25,1850,4050,2.0,4,1850,0,98029
496000.0,3,1.5,2520,37616,1.0,3,2520,0,98045
253000.0,3,2.25,1440,9806,1.0,3,1440,0,98030
299000.0,3,2.5,2450,7062,2.0,3,2450,0,98023
265000.0,3,2.0,1570,5706,1.0,3,1570,0,98092
865000.0,3,1.75,2090,4725,2.0,3,1610,480,98199
626000.0,3,2.0,2150,7200,1.0,3,2150,0,98029
675000.0,4,2.5,2370,9679,2.0,3,2370,0,98027
395000.0,3,2.5,1610,3755,2.0,3,1610,0,98052
374500.0,3,1.5,1330,8636,1.0,4,1330,0,98034
850000.0,4,2.25,2330,10451,2.0,4,2330,0,98005
304000.0,3,2.5,1710,6773,2.0,3,1710,0,98003
454000.0,3,2.0,1700,10000,2.0,3,1700,0,98011
406000.0,4,1.5,1920,6000,2.0,3,1920,0,98198
242500.0,3,2.25,1770,10000,1.0,3,1340,430,98198
425000.0,4,2.5,2460,5440,2.0,3,2460,0,98058
613000.0,4,2.0,1550,4815,1.5,3,1550,0,98103
700000.0,4,2.25,2440,9450,1.5,3,2440,0,98125
625000.0,3,1.75,2060,12558,1.0,4,1350,710,98052
415000.0,3,1.75,1910,12596,1.0,3,1340,570,98072
542126.0,4,2.5,2360,43088,2.0,3,2360,0,98077
309950.0,3,1.5,1200,15606,1.0,3,1200,0,98045
726000.0,3,2.5,1890,3880,1.5,4,1460,430,98107
260000.0,4,2.0,1620,7992,2.0,4,1620,0,98031
375000.0,4,2.5,1800,8432,1.0,4,1200,600,98133
732350.0,4,2.5,2270,7665,2.0,3,2270,0,98052
297500.0,4,2.5,1910,5000,2.0,3,1910,0,98038
475000.0,3,1.5,1640,2720,1.5,3,1640,0,98115
414000.0,4,2.5,2120,6497,2.0,3,2120,0,98019
357250.0,3,1.5,1400,8840,1.0,4,1400,0,98125
279000.0,3,1.5,1280,16738,1.5,4,1280,0,98038
370000.0,3,2.25,1650,4859,2.0,3,1650,0,98011
216000.0,3,2.0,1260,4125,1.0,3,1260,0,98188
699000.0,4,2.5,2550,7312,2.0,3,2550,0,98008
419600.0,3,1.75,1680,8460,1.0,3,1180,500,98133
665000.0,3,2.0,1740,41275,1.0,3,1740,0,98045
460000.0,4,2.75,2200,9676,1.0,3,1500,700,98028
330000.0,3,2.25,1620,7150,1.0,4,1280,340,98178
479200.0,3,2.0,1510,3750,1.5,4,1510,0,98116
275000.0,3,2.0,1380,4500,1.0,3,1380,0,98038
380000.0,3,1.5,1520,4288,1.0,3,1020,500,98136
598500.0,3,2.25,2520,12000,1.0,3,2520,0,98074
595000.0,3,2.5,1910,3075,2.0,3,1910,0,98029
324950.0,3,1.5,1460,8710,1.0,3,1460,0,98166
619420.0,4,2.75,2450,14803,2.0,4,2450,0,98059
569000.0,4,1.75,1230,7890,1.0,4,1090,140,98004
425000.0,4,2.25,2060,8540,1.0,4,1540,520,98034
535000.0,4,1.5,1580,5000,1.5,3,1390,190,98107
299950.0,3,2.5,1600,9830,2.0,4,1600,0,98001
325000.0,4,1.75,1950,12500,1.0,3,1330,620,98168
570000.0,4,2.0,2000,46902,2.0,3,2000,0,98075
802000.0,3,2.25,2170,5001,2.0,3,2170,0,98103
222000.0,3,2.0,1200,6074,1.0,3,1200,0,98002
495800.0,4,1.5,1710,4600,1.5,3,1710,0,98115
310000.0,3,1.75,1840,10723,1.0,4,1220,620,98058
205000.0,3,1.5,1820,8585,1.0,4,1820,0,98055
335000.0,4,2.5,2210,7214,2.0,3,2210,0,98003
355000.0,4,2.5,2570,6466,2.0,3,2570,0,98092
557500.0,3,2.25,1820,9670,2.0,3,1820,0,98052
277500.0,4,2.25,1660,7184,1.0,3,1110,550,98188
461000.0,3,1.75,1420,5170,1.0,4,1420,0,98007
417000.0,3,2.5,1300,877,2.0,3,1060,240,98199
405000.0,3,1.5,1330,12500,1.0,3,1330,0,98027
299000.0,3,2.25,1940,9100,1.0,4,1630,310,98023
299000.0,3,1.75,2100,15480,1.0,3,2100,0,98001
277950.0,3,2.5,2100,6021,2.0,3,2100,0,98023
770000.0,3,2.75,2070,54557,2.0,3,2070,0,98058
525000.0,4,2.5,2520,7731,2.0,3,2520,0,98155
253779.0,4,2.0,2030,9600,1.5,3,1430,600,98188
405000.0,3,1.5,1880,7400,1.0,3,1480,400,98155
221000.0,3,2.25,1430,5999,2.0,3,1430,0,98023
432250.0,3,2.25,1440,6232,2.0,3,1440,0,98029
478000.0,3,2.25,1570,9500,1.0,4,1070,500,98033
249000.0,4,2.25,1860,9576,1.0,3,1400,460,98032
550000.0,4,2.5,2150,27540,2.0,3,2150,0,98053
350000.0,3,2.5,2440,18674,2.0,4,2440,0,98042
488250.0,4,2.0,1830,9610,1.0,3,1830,0,98033
625000.0,3,2.25,1920,8412,1.0,3,1460,460,98006
610000.0,3,2.5,2060,8893,2.0,3,2060,0,98006
322500.0,4,2.25,2140,9377,2.0,4,2140,0,98092
525000.0,3,1.5,1380,4290,1.0,3,1080,300,98107
650000.0,3,1.5,1380,4290,1.0,3,1080,300,98107
356000.0,4,2.0,2020,48693,1.5,3,2020,0,98045
410000.0,3,1.75,1440,7112,1.0,3,1180,260,98034
512500.0,4,1.75,1540,8311,1.0,4,1540,0,98125
566000.0,4,1.75,1900,10297,1.0,4,1900,0,98005
830000.0,3,1.5,1840,10125,1.0,4,1220,620,98040
593700.0,3,2.5,2000,22000,2.0,3,2000,0,98075
712500.0,3,1.5,1660,8797,1.0,4,1660,0,98004
600000.0,4,1.5,1770,6014,1.5,4,1240,530,98116
554663.0,3,2.0,1230,6802,1.5,3,1230,0,98105
245000.0,3,2.5,1770,6187,2.0,3,1770,0,98031
308550.0,3,2.0,1600,13200,1.0,3,1600,0,98045
225000.0,3,1.75,1330,13102,1.0,3,1330,0,98003
634000.0,3,2.5,2490,4904,2.0,3,2490,0,98029
350000.0,3,1.75,1250,13775,1.0,3,1250,0,98045
480000.0,3,2.25,1680,9090,1.0,4,1130,550,98008
281000.0,3,1.75,1350,8737,1.0,3,1350,0,98188
620000.0,3,2.25,2190,45738,1.0,3,2190,0,98052
275000.0,3,1.75,1890,5000,1.0,3,1890,0,98092
641000.0,3,1.75,1480,9603,1.0,3,1480,0,98004
830000.0,4,2.75,2090,13500,1.0,4,2090,0,98040
659000.0,4,2.0,2090,10800,1.0,4,2090,0,98040
625000.0,3,2.25,1970,4564,1.0,3,1470,500,98199
350000.0,3,1.75,1820,9545,1.0,3,1230,590,98155
632500.0,4,2.0,1770,5000,2.0,4,1770,0,98107
385000.0,4,1.75,2080,8215,2.0,4,2080,0,98155
361000.0,3,1.5,1200,7236,1.0,3,1200,0,98011
455000.0,3,2.25,1870,7403,1.0,3,1870,0,98125
421000.0,4,2.25,1310,8400,1.0,4,1310,0,98034
640000.0,4,2.0,1520,6200,1.5,3,1520,0,98115
463000.0,3,1.75,1710,7320,1.0,3,1710,0,98155
705000.0,3,2.5,2500,10359,2.0,3,2500,0,98074
470000.0,4,2.5,2520,9684,2.0,3,2520,0,98045
898888.0,3,2.5,2080,3729,2.0,3,2080,0,98033
312500.0,3,1.75,1490,9493,1.0,4,1490,0,98058
455000.0,4,2.5,1770,13168,2.0,3,1770,0,98019
325000.0,3,1.75,1790,27427,1.0,3,1130,660,98065
495000.0,4,2.25,2070,20280,2.0,4,2070,0,98072
415000.0,3,2.25,1640,5880,1.0,3,1240,400,98106
522000.0,3,1.75,1630,15600,1.0,3,1630,0,98033
411000.0,4,2.75,2500,5257,2.0,3,2500,0,98118
816000.0,3,1.5,1180,8545,1.0,3,1180,0,98004
533250.0,4,1.75,1520,15398,1.0,4,1370,150,98027
702000.0,3,2.5,2190,8528,1.0,3,1760,430,98033
586000.0,4,2.25,2130,9000,2.0,4,2130,0,98006
532000.0,3,2.5,1820,4910,2.0,3,1820,0,98029
540000.0,4,2.25,1330,8400,1.5,3,1330,0,98005
445000.0,3,1.75,1360,4998,1.0,3,1360,0,98108
214946.0,3,1.75,1290,8688,1.0,4,1290,0,98042
205000.0,3,1.75,1200,8631,1.0,3,1200,0,98198
414250.0,4,1.75,1640,13566,1.0,4,1120,520,98072
524000.0,3,1.5,1310,9471,1.0,4,1310,0,98052
510000.0,3,2.0,1430,9250,1.0,4,990,440,98052
265000.0,3,1.5,1530,7500,1.5,3,1530,0,98038
203000.0,3,2.25,1630,9145,1.0,3,1630,0,98146
347500.0,3,1.75,1620,7500,1.0,3,1220,400,98059
645000.0,4,2.5,2250,10696,2.0,3,2250,0,98006
280000.0,3,2.0,1790,42399,1.0,4,1790,0,98092
790000.0,3,1.5,2390,4452,2.0,3,1790,600,98126
442000.0,3,1.5,2050,6384,1.0,3,1350,700,98126
325000.0,4,2.5,1930,8458,2.0,3,1930,0,98038
210000.0,4,1.75,1200,7680,1.0,3,1200,0,98092
308000.0,3,1.75,1680,8629,1.0,3,1200,480,98198
450000.0,3,2.5,1639,2710,2.0,3,1479,160,98144
550000.0,3,1.75,1940,8376,1.0,4,1290,650,98006
455000.0,3,2.25,2180,6850,1.0,3,1750,430,98034
490000.0,3,2.0,2370,12196,2.0,4,2370,0,98033
420000.0,4,2.25,2270,9100,2.0,3,2270,0,98034
357823.0,3,1.5,1240,9196,1.0,3,1240,0,98072
425000.0,3,2.25,1670,9500,1.0,3,1170,500,98125
825000.0,4,1.5,1890,6938,1.5,3,1890,0,98116
475000.0,3,1.5,1480,13457,1.0,3,1480,0,98007
635000.0,3,2.5,1530,2978,1.0,3,1210,320,98117
405000.0,3,2.25,1590,7267,1.0,4,1100,490,98133
880000.0,4,2.5,2350,4675,2.0,3,2150,200,98112
239000.0,4,2.0,1370,8837,1.5,3,1370,0,98188
215000.0,4,2.25,1500,5393,2.0,3,1500,0,98001
442500.0,3,1.5,1800,8303,1.0,3,1200,600,98133
433500.0,3,1.75,1540,9450,1.0,4,1040,500,98103
450000.0,3,2.25,1610,8296,2.0,3,1610,0,98115
675000.0,3,2.25,1990,10260,2.0,4,1990,0,98052
535000.0,3,2.5,2070,4132,2.0,3,2070,0,98074
577000.0,3,1.75,1760,12874,1.0,4,1230,530,98005
480000.0,3,1.75,1740,8528,1.0,4,1290,450,98125
400000.0,3,1.5,1950,4473,1.0,4,1530,420,98034
355000.0,3,1.75,1460,7203,1.0,3,1460,0,98056
550000.0,4,1.75,2410,8447,2.0,4,2060,350,98074
550000.0,4,1.75,2410,8447,2.0,4,2060,350,98074
210000.0,3,1.75,1400,7300,2.0,3,1400,0,98178
317000.0,3,2.5,2100,7587,2.0,3,2100,0,98023
600000.0,4,2.5,2420,7744,2.0,3,2420,0,98056
364950.0,4,2.5,2310,8030,2.0,3,2310,0,98019
576000.0,4,2.5,2590,5756,2.0,3,2590,0,98065
432000.0,3,1.75,1470,6250,1.0,4,1070,400,98155
375000.0,4,2.25,2330,11400,1.0,4,2330,0,98058
276000.0,4,2.25,2460,11250,1.0,4,2460,0,98002
279000.0,3,2.5,1450,4106,2.0,3,1450,0,98038
750000.0,4,1.5,1950,6300,1.5,3,1650,300,98115
415000.0,3,1.75,1770,10513,1.0,4,1400,370,98028
580000.0,3,2.5,1980,1873,2.0,3,1470,510,98107
499900.0,3,2.5,2100,5112,2.0,3,2100,0,98065
241250.0,3,1.75,1350,7588,1.0,3,1350,0,98010
247500.0,4,1.75,2290,7765,1.0,3,2290,0,98146
282500.0,3,2.25,1670,7150,2.0,4,1670,0,98042
395000.0,3,1.75,1460,22651,1.0,4,1460,0,98027
770000.0,3,1.75,1900,6334,1.0,3,1450,450,98105
346150.0,3,2.0,2140,7200,1.0,4,1480,660,98056
290000.0,3,2.0,1810,11456,1.0,3,1810,0,98045
276000.0,3,1.5,1820,8750,1.0,4,1200,620,98198
619000.0,3,2.5,2040,7503,2.0,3,2040,0,98029
494000.0,4,2.25,1790,42000,1.0,3,1170,620,98045
412450.0,3,2.0,1910,13505,1.0,3,1910,0,98034
580000.0,3,1.75,1460,2800,2.0,3,1460,0,98117
267000.0,3,2.0,1390,6005,2.0,3,1390,0,98022
310000.0,4,1.75,1880,12150,1.0,3,1280,600,98023
227064.0,3,1.5,1570,10824,2.0,3,1570,0,98118
245000.0,3,1.75,1670,11452,1.0,3,1670,0,98022
439000.0,4,2.0,1560,7500,1.0,4,1560,0,98034
560000.0,3,2.25,2070,15002,1.5,3,2070,0,98155
725000.0,3,2.5,2090,9847,2.0,3,2090,0,98006
383000.0,3,2.5,1720,10031,2.0,3,1720,0,98028
244000.0,3,1.75,1460,4692,1.0,3,1460,0,98055
300000.0,3,2.0,1310,9855,1.0,3,1310,0,98034
324888.0,4,1.75,2160,28750,2.0,4,2160,0,98092
435000.0,4,2.0,1650,4745,1.0,3,1130,520,98034
252000.0,3,2.25,1570,8410,1.0,3,1180,390,98022
350000.0,3,1.75,1660,10150,1.5,3,1660,0,98133
280000.0,3,2.0,1780,11342,1.0,3,1780,0,98148
450000.0,3,2.5,2180,4226,2.0,3,2180,0,98011
382450.0,3,2.5,2220,20531,2.0,3,2220,0,98001
246700.0,3,2.0,1610,13309,1.0,4,1610,0,98042
458000.0,3,1.5,1470,9570,1.0,3,1280,190,98125
265000.0,3,2.0,1340,6783,1.0,4,1340,0,98030
280000.0,3,2.5,1800,8697,2.0,3,1800,0,98023
417000.0,3,1.75,1590,11454,1.0,4,1590,0,98056
198500.0,3,1.75,1520,7137,1.0,3,1520,0,98168
350000.0,4,2.5,2560,5428,2.0,3,2560,0,98042
441000.0,3,1.5,1540,7200,1.0,3,1540,0,98011
462600.0,3,1.75,1430,11761,1.0,4,1430,0,98052
365070.0,4,2.5,2506,6232,2.0,3,2506,0,98030
340000.0,3,1.75,1540,10400,1.0,3,1540,0,98024
405000.0,4,1.75,1690,8392,1.0,3,1190,500,98028
661000.0,4,2.25,1990,4600,1.5,4,1420,570,98126
635000.0,4,2.5,2410,7069,2.0,3,2410,0,98034
235000.0,4,1.75,1720,10137,2.0,3,1720,0,98188
277500.0,3,2.0,1260,22100,2.0,4,1260,0,98023
360000.0,4,2.25,1930,6508,2.0,3,1930,0,98019
245000.0,3,2.5,1820,6785,1.0,3,1420,400,98092
525000.0,3,1.75,1600,9579,1.0,3,1180,420,98072
523000.0,3,1.5,1240,7735,1.0,4,1240,0,98008
399950.0,3,2.5,1610,1320,2.0,3,1280,330,98144
545000.0,3,2.5,1990,5149,2.0,3,1990,0,98075
260000.0,4,1.75,1960,8400,1.0,4,1960,0,98023
290000.0,3,2.25,1500,7482,1.0,4,1210,290,98055
631000.0,3,2.25,1670,1396,2.0,3,1250,420,98115
415000.0,3,2.5,2480,8342,2.0,3,2480,0,98058
222000.0,3,1.75,1240,7560,1.0,3,1070,170,98003
245000.0,3,2.0,1390,8250,1.0,3,1390,0,98042
420250.0,3,2.0,1510,3657,1.0,3,1510,0,98053
320000.0,4,2.5,1920,7277,2.0,4,1920,0,98031
359950.0,3,2.5,1980,7800,2.0,3,1980,0,98055
245000.0,4,1.5,2010,7561,1.5,4,1890,120,98002
273000.0,3,2.25,1930,8192,1.0,3,1470,460,98003
400000.0,3,1.75,2110,19600,1.0,4,2110,0,98055
790000.0,3,1.75,2050,4080,2.0,3,2050,0,98105
360000.0,3,1.5,1800,22000,2.0,3,1800,0,98168
341000.0,3,2.25,1750,8900,2.0,4,1750,0,98058
335000.0,4,2.5,2154,6050,2.0,3,2154,0,98030
393500.0,3,1.75,1230,1441,2.0,3,1010,220,98116
360000.0,3,1.5,1340,1110,2.0,3,1040,300,98117
665900.0,4,2.25,2870,5453,2.0,4,2220,650,98146
606000.0,3,2.5,2200,6005,2.0,3,2200,0,98072
512500.0,3,2.5,1900,7604,2.0,3,1900,0,98033
480680.0,3,2.5,1730,4924,2.0,3,1730,0,98029
305000.0,4,2.0,1800,13551,1.0,4,1800,0,98059
285000.0,3,1.75,1600,7500,1.0,3,1600,0,98002
379260.0,3,2.5,1730,7202,1.0,3,1330,400,98198
356000.0,3,2.5,1590,3411,2.0,3,1590,0,98065
571900.0,4,1.75,1710,8947,1.0,4,1710,0,98007
271500.0,3,1.75,1995,18360,2.0,3,1995,0,98198
390000.0,3,1.75,1300,10030,1.0,4,1300,0,98034
268000.0,3,2.75,1880,1793,2.0,3,1810,70,98108
514000.0,3,2.0,1770,7200,1.0,4,1770,0,98033
725000.0,3,2.5,2610,7510,2.0,3,2610,0,98052
271900.0,3,2.0,1450,8771,2.0,4,1450,0,98022
619500.0,3,2.5,2170,5000,2.0,3,2170,0,98029
235000.0,3,1.75,1370,14030,1.0,4,1370,0,98092
199500.0,3,1.75,1690,8901,1.0,3,1690,0,98030
260000.0,3,2.5,1490,8102,2.0,4,1490,0,98042
242150.0,4,1.75,1490,8544,1.0,4,1490,0,98031
220000.0,3,1.75,1230,7200,1.0,3,1230,0,98023
235000.0,3,2.0,1900,7980,1.0,4,1340,560,98023
370000.0,3,1.75,1530,10300,1.0,4,1530,0,98133
300000.0,3,2.75,1910,15508,1.0,3,1210,700,98023
430000.0,3,2.0,1510,7066,1.0,3,1230,280,98125
183000.0,3,1.5,1280,4366,2.0,4,1280,0,98002
346950.0,3,1.75,1830,10954,1.0,3,1830,0,98155
315000.0,3,1.75,1460,7884,1.0,3,1460,0,98058
649950.0,3,2.5,1500,1375,2.0,3,1200,300,98119
410000.0,4,2.25,2200,8292,2.0,3,2200,0,98155
455000.0,3,2.5,1870,7344,1.0,3,1470,400,98034
371000.0,4,1.75,1610,11305,1.0,3,1610,0,98034
289500.0,3,2.25,2120,3400,2.0,3,2120,0,98092
330000.0,3,1.75,1460,9261,1.0,3,1460,0,98056
705000.0,4,1.5,1780,3120,1.5,3,1780,0,98118
380000.0,3,2.25,1600,39848,1.0,4,1600,0,98022
348500.0,3,1.5,1360,10726,1.0,4,1360,0,98059
370000.0,3,1.5,1360,10726,1.0,4,1360,0,98059
230000.0,3,1.75,1340,8250,1.0,3,1100,240,98042
562000.0,4,1.75,2060,4080,1.5,3,1460,600,98105
659950.0,3,2.5,1610,1246,2.0,3,1080,530,98119
458500.0,3,2.0,1890,1599,2.0,3,1430,460,98136
366000.0,3,1.75,1680,6108,1.0,3,1680,0,98055
453000.0,3,2.5,1750,3900,2.0,3,1750,0,98052
800000.0,4,1.75,2150,9148,1.0,4,2150,0,98004
499950.0,4,1.75,1520,7700,1.0,4,1520,0,98034
350000.0,3,2.5,1640,10424,2.0,3,1640,0,98019
458000.0,4,1.5,1550,3000,1.5,3,1350,200,98105
450000.0,3,2.25,1960,6500,2.0,4,1960,0,98052
700000.0,3,1.75,1820,15570,1.0,3,1820,0,98146
580000.0,3,2.25,1640,8625,1.0,3,1320,320,98052
240000.0,3,1.75,1780,5000,1.5,3,1080,700,98146
249950.0,4,1.75,1620,10530,1.0,3,1620,0,98030
575000.0,3,1.75,1530,6743,1.0,3,1410,120,98116
235000.0,3,1.5,1980,11214,1.0,3,1980,0,98168
270000.0,4,2.5,1810,6509,2.0,3,1810,0,98042
335000.0,3,2.25,2150,30476,2.0,3,2150,0,98188
374950.0,4,1.5,1970,14490,1.5,4,1970,0,98059
247000.0,3,2.25,1640,7630,1.0,4,1180,460,98032
225000.0,4,2.5,1700,6031,2.0,3,1700,0,98030
685000.0,4,2.5,2770,6000,2.0,3,2400,370,98136
825000.0,4,1.5,2040,6900,2.0,3,2040,0,98112
620000.0,3,1.75,2410,35236,1.0,3,2410,0,98072
470000.0,3,1.5,1500,5000,1.5,4,1140,360,98117
500000.0,3,2.25,1360,1236,2.0,3,1140,220,98112
507000.0,3,2.25,2210,11585,1.0,4,1510,700,98155
369000.0,3,2.5,1320,1683,2.0,3,1270,50,98106
520000.0,3,2.0,1410,2700,2.0,4,1410,0,98122
308000.0,4,2.5,2020,7277,2.0,3,2020,0,98055
340000.0,3,2.5,2270,7917,2.0,3,2270,0,98092
716000.0,3,2.0,1420,3600,1.5,4,1420,0,98119
564500.0,4,2.25,1950,6000,1.0,3,1350,600,98115
393000.0,4,1.75,1790,11801,1.0,4,1790,0,98056
305000.0,4,2.5,2100,14773,2.0,3,2100,0,98023
300000.0,4,2.5,2200,8065,2.0,3,2200,0,98031
413107.0,3,1.5,1420,7520,1.0,4,1420,0,98007
312000.0,3,2.5,2280,6386,2.0,3,2280,0,98042
285000.0,3,1.5,1490,10367,1.0,3,1010,480,98146
425000.0,4,2.5,2440,5088,2.0,3,2440,0,98065
360000.0,3,2.0,1930,15540,1.0,3,1260,670,98155
369000.0,3,2.0,1550,8509,1.0,3,1150,400,98106
275000.0,4,2.5,2180,11132,1.0,4,1620,560,98023
810000.0,3,1.5,1520,9041,1.0,4,1520,0,98004
274000.0,3,1.75,1590,7620,1.0,4,1090,500,98038
239900.0,4,1.75,1480,9523,1.0,3,1120,360,98030
390000.0,3,2.0,2360,5737,2.0,3,2360,0,98028
650000.0,4,2.25,2330,7220,2.0,3,1600,730,98177
397500.0,3,1.75,1300,8480,1.0,3,1300,0,98052
290000.0,3,1.75,2060,7251,1.0,3,1350,710,98030
530000.0,4,2.25,2410,14985,1.0,4,1950,460,98166
599000.0,4,2.5,2480,5000,2.0,3,2480,0,98053
362300.0,3,2.5,2430,15264,2.0,3,2430,0,98030
421000.0,3,2.5,1930,4505,1.0,4,1440,490,98198
302500.0,3,2.5,1690,4476,2.0,3,1690,0,98042
259950.0,4,1.75,1400,7920,1.0,3,1400,0,98058
456000.0,3,1.5,1440,28516,1.0,4,1440,0,98075
369950.0,3,2.5,1360,3718,2.0,3,1360,0,98052
268000.0,3,2.5,1850,6676,2.0,3,1850,0,98023
539000.0,4,2.5,2340,19850,2.0,3,2340,0,98155
900000.0,3,2.5,1920,7200,2.0,3,1780,140,98116
390000.0,3,1.75,1260,6500,1.0,4,1260,0,98008
534500.0,3,2.5,1700,3150,2.0,3,1700,0,98029
435000.0,4,2.5,2190,6578,2.0,3,2190,0,98065
305000.0,4,2.0,2470,1831,2.0,3,1970,500,98166
799000.0,4,2.5,2590,7910,2.0,3,2590,0,98115
700000.0,4,2.5,2580,15031,2.0,3,2580,0,98052
467000.0,3,2.25,1270,1213,2.0,3,1040,230,98107
293000.0,4,2.5,2019,4435,2.0,3,2019,0,98022
245000.0,3,2.0,1490,7929,1.0,3,1490,0,98002
285000.0,3,2.0,1460,6377,1.0,3,1460,0,98038
325000.0,4,2.5,1960,3543,2.0,3,1960,0,98056
405000.0,3,1.75,1900,10454,1.0,3,1390,510,98155
370000.0,3,2.5,2490,18525,2.0,3,2490,0,98022
270000.0,3,1.5,1430,8960,1.0,4,1430,0,98166
419000.0,3,1.75,2140,15030,1.0,4,1570,570,98166
865000.0,4,2.5,2260,13600,1.0,4,1770,490,98040
295000.0,4,1.75,1400,11934,1.0,3,1050,350,98028
397500.0,3,2.5,1860,44093,1.0,3,1860,0,98055
415900.0,3,2.5,1670,22703,1.0,3,1310,360,98045
296000.0,4,1.5,1370,9750,1.0,3,1070,300,98168
390000.0,3,2.25,1650,6250,1.5,3,1650,0,98116
605000.0,3,2.25,2080,12134,1.0,4,1530,550,98052
435000.0,4,2.25,1910,8400,2.0,3,1910,0,98072
560200.0,3,2.5,1990,3984,2.0,3,1990,0,98075
390000.0,4,2.5,2490,8290,2.0,3,2490,0,98092
441500.0,3,2.5,2360,4670,2.0,3,2360,0,98065
375000.0,3,2.5,1770,5146,2.0,3,1770,0,98106
758000.0,4,2.75,2410,9549,1.0,4,1780,630,98033
736000.0,4,2.5,2290,12047,2.0,4,2290,0,98006
670000.0,3,1.5,1490,4400,1.5,4,1490,0,98122
650000.0,4,2.0,1930,3976,1.5,4,1930,0,98122
610000.0,4,2.25,2240,45738,2.0,3,2240,0,98053
765000.0,3,2.5,2300,9752,2.0,3,2300,0,98075
465000.0,3,2.5,1450,5175,1.0,3,1030,420,98133
556000.0,4,2.5,2240,5402,2.0,3,2240,0,98133
540000.0,4,2.5,1780,4169,2.0,3,1780,0,98029
423000.0,4,2.5,2320,4254,2.0,3,2320,0,98059
375000.0,3,1.75,1590,14766,1.0,3,1590,0,98007
670000.0,4,2.0,2250,4200,1.5,3,1650,600,98122
299800.0,4,2.5,2410,4708,2.0,3,2410,0,98092
415000.0,3,2.5,1280,5040,2.0,4,1280,0,98118
800000.0,3,2.75,2220,4000,2.0,3,1700,520,98122
440000.0,4,1.5,1770,5750,2.0,3,1770,0,98116
495000.0,3,2.0,2950,12196,2.0,4,2310,640,98166
379600.0,3,1.75,1270,12420,1.0,4,1270,0,98056
530000.0,4,2.5,2050,6360,2.0,3,2050,0,98029
545000.0,4,2.25,2050,9720,2.0,3,2050,0,98008
565000.0,4,2.75,1960,48787,1.5,4,1960,0,98072
502000.0,3,1.75,1300,8800,1.0,4,1300,0,98008
425000.0,3,2.25,1260,3000,2.0,3,1260,0,98029
233500.0,3,2.25,1650,2958,2.0,3,1650,0,98031
287000.0,3,2.5,1710,10341,2.0,3,1710,0,98030
393000.0,3,2.25,2140,10256,2.0,3,2140,0,98038
680000.0,3,2.5,2060,2551,2.0,3,1900,160,98005
219000.0,3,1.5,1740,5200,1.0,4,1060,680,98042
528000.0,4,2.75,2050,7171,1.0,3,1540,510,98074
405000.0,3,1.75,1980,8100,1.0,4,1310,670,98133
372977.0,3,2.5,1690,1618,2.0,3,1150,540,98029
315000.0,3,1.75,1480,6800,1.0,4,1480,0,98055
490000.0,3,1.75,1660,8208,1.0,4,1660,0,98005
480000.0,4,1.75,2220,6500,2.0,4,2220,0,98166
205500.0,3,2.0,1330,8748,1.0,3,1330,0,98003
275000.0,4,2.5,2120,6754,2.0,3,2120,0,98030
248500.0,3,1.75,2090,12026,1.0,4,2090,0,98002
390000.0,4,2.75,1790,47250,1.0,3,1220,570,98045
390000.0,3,2.75,1950,12240,1.0,3,1250,700,98028
717000.0,3,2.5,2480,5137,2.0,3,2480,0,98052
429000.0,3,2.5,2530,8820,2.0,3,2530,0,98031
220000.0,4,2.0,1400,7140,1.0,3,1400,0,98155
259000.0,3,2.0,1390,7120,1.0,3,1390,0,98030
538000.0,3,1.75,1400,3825,1.5,4,1100,300,98117
310000.0,3,2.5,1670,4220,2.0,3,1670,0,98038
274000.0,4,2.25,2090,7400,1.0,3,1670,420,98023
410000.0,3,2.0,1410,8088,1.0,3,1410,0,98034
650000.0,4,2.25,1910,5120,1.0,3,1300,610,98199
353000.0,3,2.0,1678,13862,1.0,3,1678,0,98030
437500.0,3,2.25,1790,7700,1.0,4,1340,450,98034
567000.0,3,2.5,2540,6093,2.0,3,2540,0,98034
310000.0,3,1.75,2070,37904,1.0,4,1420,650,98058
895000.0,4,2.25,1950,5950,1.0,3,1330,620,98109
349000.0,4,2.5,1830,4694,2.0,3,1830,0,98038
650500.0,3,1.75,1740,4400,1.5,3,1740,0,98122
760000.0,3,1.75,1410,15120,1.0,4,1410,0,98004
339900.0,3,2.5,2420,7423,2.0,3,2420,0,98092
233000.0,3,2.0,1350,7686,1.0,3,1350,0,98038
248000.0,3,1.75,1840,19501,1.0,4,1270,570,98003
224000.0,3,1.5,1560,7300,1.0,4,1040,520,98001
440000.0,3,2.5,2160,3738,2.0,3,2160,0,98126
525000.0,3,2.75,2100,10362,2.0,3,1510,590,98045
375000.0,3,1.5,1370,9720,2.0,3,1370,0,98034
199950.0,3,1.75,1550,6225,1.0,4,1550,0,98002
840000.0,4,2.25,2100,3671,1.5,3,1750,350,98112
220000.0,4,2.25,1950,7280,2.0,4,1950,0,98023
325000.0,3,2.5,1880,6818,2.0,3,1880,0,98031
268000.0,3,1.75,1370,10050,1.0,4,1370,0,98023
275000.0,3,1.75,1300,20700,1.0,3,1300,0,98024
369500.0,3,1.75,1300,20700,1.0,3,1300,0,98024
215000.0,4,2.0,1540,7575,1.0,4,1040,500,98032
593450.0,4,2.25,2130,7172,2.0,4,2130,0,98008
265000.0,3,1.75,1680,9769,1.0,3,1340,340,98058
240000.0,3,1.75,1590,7931,1.0,3,1190,400,98038
250000.0,4,2.0,1850,7560,1.0,4,1540,310,98032
562200.0,3,1.5,1900,5250,1.0,4,1500,400,98117
332900.0,3,1.5,1190,11996,1.0,4,1190,0,98077
721000.0,3,2.25,2040,18360,2.0,4,2040,0,98052
487275.0,4,2.5,2400,3986,2.0,3,2400,0,98065
310000.0,3,2.5,1670,5791,2.0,3,1670,0,98055
550000.0,3,1.75,1840,9401,1.0,3,1840,0,98075
259950.0,3,1.5,1240,9500,1.0,4,1240,0,98166
240000.0,4,2.5,1980,7264,2.0,3,1980,0,98038
395000.0,3,1.5,1280,15028,1.0,3,1280,0,98074
572000.0,3,1.5,1680,13751,1.0,4,1680,0,98040
419500.0,3,2.5,1360,3188,2.0,3,1360,0,98052
298700.0,3,2.25,2110,7350,1.0,3,1530,580,98023
499900.0,4,2.25,2360,7650,1.0,3,1640,720,98155
832500.0,3,2.0,1870,9527,1.0,4,1870,0,98040
369000.0,4,2.75,2420,6495,2.0,3,2420,0,98038
360000.0,4,2.5,1950,5451,2.0,3,1950,0,98058
672500.0,3,2.5,2450,5760,2.0,3,2450,0,98074
268000.0,4,1.5,1730,7020,1.5,4,1730,0,98056
440000.0,4,1.5,1690,3245,1.5,3,1690,0,98126
590000.0,4,2.5,2290,11072,2.0,3,2290,0,98074
266500.0,4,1.75,1880,7632,1.0,4,1180,700,98023
650000.0,4,2.25,2440,9320,1.0,4,1880,560,98007
425000.0,4,1.75,1980,8400,1.0,3,1330,650,98052
278000.0,4,2.0,1480,6324,1.0,3,1480,0,98122
474900.0,3,2.25,1800,43647,1.0,4,1800,0,98072
317000.0,3,2.5,1840,5011,2.0,3,1840,0,98038
436000.0,3,2.25,1800,6680,2.0,3,1800,0,98034
450000.0,3,1.75,1540,9154,1.0,3,1540,0,98074
588500.0,3,1.75,2330,14892,1.0,3,1970,360,98074
340000.0,4,1.75,1400,8374,1.0,3,1400,0,98166
330000.0,3,1.5,1440,7875,1.0,4,1440,0,98058
239000.0,3,1.75,1470,8925,1.0,4,1470,0,98022
625000.0,4,2.5,2601,34335,2.0,3,2601,0,98072
690000.0,3,1.75,2070,6000,1.0,3,1340,730,98136
860000.0,3,1.75,1860,5584,1.0,3,1310,550,98199
875000.0,3,1.5,1820,12686,1.0,4,1820,0,98004
490000.0,3,2.0,2220,10275,2.0,3,1640,580,98027
550000.0,3,1.75,1670,10798,1.0,4,1670,0,98006
395000.0,3,1.75,1620,8085,1.0,3,1210,410,98011
322400.0,3,1.75,1710,15844,1.0,4,1710,0,98059
233500.0,3,1.5,1580,10517,1.0,4,1580,0,98002
400000.0,3,2.0,1230,11413,1.0,3,990,240,98074
525000.0,3,1.75,1970,8000,1.0,4,1970,0,98052
439950.0,3,2.25,2170,15000,2.0,4,2170,0,98042
453000.0,4,2.0,1880,5100,1.0,3,1880,0,98103
285000.0,3,1.5,1780,12231,1.0,4,1780,0,98003
425000.0,3,1.75,1680,14630,1.5,3,1680,0,98027
540000.0,4,2.5,2290,4450,2.0,3,2290,0,98072
576000.0,3,1.75,1500,13891,1.0,4,1500,0,98005
525000.0,3,1.75,1720,7200,1.0,3,1140,580,98052
266000.0,4,2.25,1995,7102,2.0,4,1995,0,98023
415000.0,3,1.75,1270,4800,1.0,3,1270,0,98126
235000.0,3,2.25,1670,7606,2.0,3,1670,0,98022
280000.0,3,2.0,1470,8089,1.0,3,1470,0,98198
459000.0,3,1.75,1730,7807,1.0,3,1260,470,98034
235000.0,3,1.5,1660,8738,1.0,4,1080,580,98002
711800.0,4,2.25,2410,16650,1.0,4,2410,0,98006
560000.0,3,1.75,2340,12443,1.5,4,2340,0,98006
340000.0,3,1.75,1880,11249,1.0,3,1330,550,98001
337000.0,4,2.0,1590,8779,1.0,3,1590,0,98019
269950.0,3,2.25,1510,6000,1.0,4,1150,360,98038
475000.0,4,2.25,2110,7560,2.0,4,2110,0,98034
339000.0,3,2.0,2350,8459,1.5,3,2350,0,98023
460000.0,3,2.0,1760,9055,2.0,4,1760,0,98052
670000.0,3,1.75,1850,8160,1.0,3,1850,0,98177
461550.0,3,1.5,2090,11895,1.0,3,1790,300,98118
479990.0,3,2.5,2010,2386,2.0,3,1390,620,98029
643000.0,4,2.5,2518,4663,2.0,3,2518,0,98075
625000.0,3,2.5,2600,10092,1.0,3,2600,0,98074
435000.0,4,2.5,2130,10375,2.0,4,2130,0,98058
740000.0,3,1.75,2020,9478,1.0,4,2020,0,98040
250000.0,3,2.0,1430,7280,1.0,3,990,440,98030
300000.0,4,2.5,1910,8058,2.0,3,1910,0,98031
360000.0,3,1.75,1330,7482,1.0,4,1330,0,98034
240000.0,3,1.75,1570,8750,1.0,3,1570,0,98148
355000.0,3,2.25,1960,7000,1.0,3,1600,360,98058
823000.0,3,2.5,2560,9825,2.0,4,2560,0,98006
833000.0,4,1.75,2260,12238,1.0,3,2260,0,98005
479000.0,3,2.25,2110,11319,2.0,4,2110,0,98072
490000.0,3,2.5,2010,9725,2.0,4,2010,0,98029
422500.0,3,1.75,1560,7245,1.5,3,1560,0,98052
310000.0,4,2.5,2430,5499,2.0,3,2430,0,98042
492000.0,3,2.25,2100,7335,2.0,3,2100,0,98074
470000.0,4,2.75,2310,7350,1.0,3,1670,640,98011
210000.0,4,1.5,1920,10403,1.0,3,1370,550,98023
245000.0,3,1.75,1720,9342,1.0,4,1140,580,98092
540000.0,3,2.25,2100,20018,1.0,3,1470,630,98166
299000.0,4,2.5,2400,6078,2.0,3,2400,0,98001
510000.0,3,2.5,2540,40106,2.0,3,2540,0,98074
300000.0,4,1.75,2200,7600,2.0,3,2200,0,98092
255000.0,3,1.75,1340,7210,1.0,4,1340,0,98031
320000.0,3,2.5,2130,6969,2.0,3,2130,0,98038
565000.0,4,2.5,2240,14667,2.0,4,2240,0,98059
432000.0,3,2.5,1920,9812,2.0,3,1920,0,98028
395000.0,3,2.5,2250,3757,2.0,3,2250,0,98059
420000.0,3,2.5,2480,6180,2.0,3,2480,0,98031
822000.0,3,2.0,2410,13300,2.0,3,1840,570,98006
485000.0,3,2.25,1570,6810,1.0,3,1180,390,98074
590000.0,3,2.5,2290,4203,2.0,3,2290,0,98006
200500.0,3,2.0,1280,14972,1.0,3,1280,0,98031
308000.0,3,2.5,2320,7140,2.0,3,2320,0,98003
290256.0,3,2.25,1720,7885,2.0,3,1720,0,98023
279950.0,3,1.75,1530,8800,1.0,4,1040,490,98058
195000.0,3,1.75,1580,7875,1.0,3,1580,0,98022
478000.0,3,2.25,1640,3896,2.0,3,1640,0,98029
639000.0,3,2.25,1400,2421,2.0,3,1400,0,98034
623000.0,4,2.75,2300,12633,2.0,3,2300,0,98074
220000.0,3,1.75,1900,7680,1.0,3,1260,640,98178
355000.0,3,2.5,2110,4038,2.0,4,2110,0,98042
650000.0,3,1.75,1970,54450,1.0,3,1570,400,98075
572000.0,3,2.75,2200,3885,2.0,3,2200,0,98074
813000.0,3,1.75,2080,11866,1.0,3,2080,0,98005
710000.0,3,2.0,1780,9732,1.0,3,1780,0,98040
792500.0,3,1.5,1960,2400,2.0,3,1330,630,98119
675000.0,3,2.25,2070,2833,2.0,3,1490,580,98136
685000.0,3,2.5,1460,8800,1.0,4,1460,0,98040
335000.0,3,2.75,1990,19991,1.0,3,1340,650,98072
250000.0,3,2.0,1170,7258,1.0,3,1170,0,98001
278500.0,3,1.75,1390,8980,1.0,4,1390,0,98022
260000.0,4,1.5,1540,7300,2.0,3,1540,0,98001
350000.0,4,2.25,1770,7778,2.0,3,1770,0,98031
545500.0,3,2.5,1560,9361,1.5,4,1360,200,98108
675000.0,3,1.75,1660,9549,1.0,3,1660,0,98033
375000.0,3,1.5,1630,16170,1.0,3,1630,0,98034
600000.0,4,2.25,2260,43847,2.0,3,2260,0,98072
292600.0,3,1.5,1520,7123,1.0,4,1520,0,98056
382000.0,3,2.25,1750,15528,1.0,3,1270,480,98155
370000.0,3,2.25,1770,7667,1.0,3,1270,500,98177
520000.0,3,2.25,1770,7667,1.0,3,1270,500,98177
424240.0,3,2.0,2080,12094,2.0,4,2080,0,98052
589950.0,3,2.0,2080,12094,2.0,4,2080,0,98052
349000.0,3,2.5,2550,7709,2.0,3,2550,0,98023
220000.0,3,1.75,1650,8850,1.0,3,1650,0,98188
440000.0,4,2.25,2080,15750,1.0,3,1460,620,98034
439990.0,4,2.5,1540,1994,2.0,3,1540,0,98029
535000.0,4,2.25,1860,3766,2.0,3,1860,0,98029
215000.0,3,1.75,1280,10016,1.0,4,1280,0,98003
349900.0,3,2.5,2200,7278,2.0,3,2200,0,98058
515100.0,3,2.5,2074,4900,2.0,3,2074,0,98034
620000.0,4,2.5,2450,55387,2.0,3,2450,0,98053
657500.0,4,2.25,2520,10370,2.0,3,2520,0,98074
307000.0,3,1.5,2320,7500,1.0,3,2320,0,98019
288000.0,3,2.5,1370,9253,1.0,3,1090,280,98042
226450.0,3,1.75,1730,7200,1.5,4,1730,0,98032
390000.0,3,2.5,1640,6991,1.0,3,1110,530,98125
368000.0,3,1.5,1560,7884,1.0,3,1060,500,98125
410000.0,3,1.75,1440,8560,1.0,4,1440,0,98034
241500.0,4,2.5,2500,9654,1.0,3,1830,670,98023
322200.0,4,2.25,2010,19000,2.0,4,2010,0,98042
335000.0,3,1.75,1270,4800,1.0,3,1270,0,98117
560000.0,4,1.75,1740,8800,1.0,4,1740,0,98007
243400.0,4,1.5,1730,7464,2.0,4,1730,0,98032
405000.0,3,2.0,1240,14404,1.0,3,1240,0,98053
350000.0,4,2.5,2140,7095,2.0,3,2140,0,98038
430000.0,4,1.75,1710,7724,1.0,3,1710,0,98155
412500.0,3,1.5,1490,8475,1.0,4,1490,0,98052
535000.0,3,2.5,2210,7620,2.0,3,2210,0,98052
390000.0,3,1.5,1650,8676,1.0,4,1130,520,98133
349000.0,4,2.5,1800,7620,2.0,3,1800,0,98055
635000.0,3,2.25,1940,7482,1.0,4,1240,700,98004
410000.0,3,1.75,1640,17583,1.0,3,1110,530,98034
449950.0,3,2.0,1560,4080,2.0,3,1560,0,98115
475000.0,4,1.75,1910,8775,1.0,3,1210,700,98028
319950.0,4,2.5,2038,7643,2.0,3,2038,0,98092
210000.0,3,2.25,1720,9435,1.0,4,1220,500,98023
485000.0,3,2.75,1670,3330,1.5,4,1670,0,98107
478000.0,4,2.0,1690,8208,1.0,4,1210,480,98008
385000.0,4,2.5,1620,5280,2.0,4,1620,0,98146
595000.0,4,2.5,2360,43017,2.0,3,2360,0,98077
285000.0,3,1.5,1480,7117,1.0,3,1170,310,98028
270000.0,3,1.75,1800,9314,2.0,3,1800,0,98011
474000.0,4,2.25,1960,14834,1.0,4,1330,630,98072
303500.0,4,2.5,1920,7345,2.0,3,1920,0,98038
350000.0,3,1.75,1470,8645,1.0,3,1470,0,98155
365500.0,4,2.5,2030,4499,2.0,3,2030,0,98058
335000.0,3,2.5,2260,8040,2.0,3,2260,0,98092
386591.0,3,2.5,1690,1613,2.0,3,1150,540,98029
399000.0,4,2.5,2870,9292,2.0,3,2540,330,98058
300000.0,3,2.5,1800,3253,2.0,3,1800,0,98108
263000.0,3,1.75,1580,9187,1.0,3,1180,400,98038
445000.0,3,2.5,1730,4408,2.0,3,1730,0,98029
554000.0,3,2.0,1910,9001,1.0,4,1910,0,98008
518000.0,4,2.5,2160,9750,2.0,3,2160,0,98028
572650.0,4,2.5,2250,11349,2.0,3,2250,0,98034
231000.0,3,2.5,1370,7247,2.0,3,1370,0,98032
244000.0,3,1.5,1360,9625,1.0,3,1360,0,98030
185850.0,3,1.5,1630,11662,1.0,3,1630,0,98188
319900.0,3,2.5,2040,7580,2.0,3,2040,0,98092
329000.0,3,2.75,1920,7700,1.0,4,1320,600,98023
475226.0,3,2.5,2120,4512,2.0,3,2120,0,98011
638000.0,3,2.5,2170,5000,2.0,3,2170,0,98029
630000.0,4,1.75,1930,10210,1.5,3,1670,260,98125
575000.0,3,2.5,2120,4780,2.0,3,2120,0,98053
345000.0,3,2.5,1990,20466,1.5,4,1410,580,98010
323000.0,4,1.75,1310,9690,1.0,4,1310,0,98011
299800.0,4,1.5,1530,9000,1.0,4,1530,0,98014
359950.0,4,2.5,1820,3899,2.0,3,1820,0,98019
375000.0,4,2.5,2090,8325,1.0,4,1470,620,98056
520000.0,4,2.5,2280,8798,2.0,4,2280,0,98028
294700.0,3,2.0,1970,9600,1.0,4,1300,670,98003
215000.0,4,2.0,1470,7000,1.0,4,1470,0,98032
433000.0,3,1.75,2160,8565,1.0,3,1730,430,98028
654000.0,4,2.5,2240,7540,1.0,3,1540,700,98115
215000.0,3,1.5,1280,5065,2.0,4,1280,0,98002
675000.0,3,1.75,1680,10500,1.0,4,1680,0,98005
290000.0,3,1.5,1310,8100,1.0,3,1310,0,98034
375000.0,3,2.5,1930,6180,1.0,3,1330,600,98155
638500.0,4,1.75,1770,12462,1.0,4,1770,0,98166
325000.0,3,2.5,1580,4698,2.0,3,1580,0,98038
270000.0,4,1.75,1560,4290,2.0,3,1560,0,98108
890000.0,3,2.25,2060,8640,1.0,4,2060,0,98033
719000.0,3,2.5,1690,4500,1.5,4,1690,0,98116
660000.0,3,2.5,2330,3995,2.0,3,2330,0,98029
575000.0,3,1.75,1890,11141,1.0,4,1890,0,98006
352500.0,3,1.75,1170,8182,1.0,3,1170,0,98155
560000.0,4,2.75,1950,6192,2.0,3,1950,0,98029
595000.0,3,1.75,2220,22081,1.5,4,2220,0,98166
810000.0,3,1.75,1980,13503,1.0,4,1320,660,98008
836000.0,4,2.5,2450,12987,1.0,4,2030,420,98007
255000.0,3,1.5,1420,7480,1.0,4,1420,0,98058
439500.0,3,2.5,2050,40003,1.0,4,1570,480,98027
268000.0,3,1.75,1250,5546,1.0,4,1250,0,98055
200000.0,4,2.75,2210,13235,2.0,3,1730,480,98003
325000.0,3,1.5,2120,41325,1.0,4,1420,700,98092
482000.0,4,2.25,2240,8322,2.0,3,2240,0,98034
532500.0,4,2.5,2490,8750,2.0,3,2040,450,98008
540000.0,4,2.5,2329,9436,2.0,3,2329,0,98011
578000.0,3,2.25,1790,9580,2.0,3,1790,0,98006
485000.0,3,2.5,2540,51836,1.0,4,1820,720,98042
355000.0,4,2.0,1870,3497,1.0,3,1200,670,98106
515000.0,4,2.25,2200,6967,2.0,3,2200,0,98011
700000.0,3,1.75,2100,5000,1.5,3,2100,0,98117
289000.0,3,2.5,1490,8628,2.0,3,1490,0,98038
230000.0,3,1.75,1450,8378,1.0,4,1450,0,98023
432500.0,3,2.5,1930,7120,1.0,4,1420,510,98133
288000.0,3,1.75,1660,10440,1.0,3,1040,620,98045
354000.0,3,1.75,1260,12330,1.0,3,1260,0,98072
260000.0,3,1.75,2170,10018,1.0,4,1630,540,98001
602000.0,4,2.5,2000,7376,2.0,3,2000,0,98029
625000.0,3,1.75,1580,20588,1.0,3,1580,0,98125
448500.0,3,2.5,2080,3920,2.0,3,2080,0,98118
385500.0,3,2.0,1540,7947,1.0,3,1120,420,98011
587000.0,4,2.75,2210,8430,2.0,3,2210,0,98075
355000.0,4,2.5,2390,6775,2.0,3,2390,0,98056
340000.0,4,2.5,2160,5455,2.0,3,2160,0,98056
540400.0,4,1.75,1680,6758,1.0,3,1680,0,98008
569000.0,3,2.5,2150,8060,2.0,3,2150,0,98033
434000.0,3,2.25,1750,9353,1.0,3,1210,540,98034
465425.0,4,2.75,2430,20720,1.0,3,2430,0,98072
406430.0,3,2.0,1380,15426,1.0,4,1380,0,98075
250000.0,3,2.5,1790,6191,2.0,3,1790,0,98031
266000.0,3,2.5,1940,8547,1.0,3,1460,480,98030
258000.0,3,2.0,1390,7200,1.0,3,1390,0,98058
530000.0,3,2.25,1264,1536,2.0,3,1264,0,98105
625000.0,4,2.0,1760,5307,1.5,4,1170,590,98105
334000.0,3,1.75,1400,7405,1.0,3,1400,0,98133
485000.0,3,1.75,1950,10080,1.0,4,1950,0,98034
353000.0,4,1.75,1780,9794,1.0,3,1780,0,98077
357500.0,3,1.5,1540,11858,1.0,4,1540,0,98059
272000.0,3,2.5,1650,13816,2.0,3,1650,0,98014
450000.0,3,1.75,2150,13789,1.0,4,1610,540,98155
235000.0,3,1.75,1840,9697,1.0,4,1500,340,98030
463000.0,3,2.5,2010,4195,2.0,3,2010,0,98034
536000.0,4,2.25,1990,5948,2.0,3,1990,0,98029
630000.0,4,2.5,2540,4727,2.0,3,2540,0,98034
362000.0,3,2.25,1640,14374,1.0,4,1140,500,98148
255000.0,3,2.0,1500,8775,1.0,3,1390,110,98166
265000.0,3,2.0,1690,9516,1.0,3,1690,0,98022
510000.0,3,2.0,1420,11325,1.0,3,1420,0,98027
242500.0,3,1.5,1200,9720,1.0,4,1200,0,98042
435000.0,3,1.75,2030,13700,1.0,3,1630,400,98011
477000.0,3,1.75,1780,8085,1.0,3,1210,570,98011
406000.0,3,1.75,1390,7904,1.0,3,1390,0,98056
350000.0,3,1.75,1900,10225,1.0,4,1220,680,98166
489000.0,3,2.5,2260,19821,2.0,3,2260,0,98058
419000.0,3,1.5,1570,6700,1.0,4,1570,0,98007
668500.0,4,2.25,2290,9546,1.0,4,1780,510,98006
315000.0,4,2.0,2020,7767,1.0,3,2020,0,98003
800000.0,3,2.5,2100,4440,2.0,3,2100,0,98116
516130.0,3,1.75,1510,8250,1.0,4,1510,0,98008
689000.0,4,2.5,2020,9600,2.0,4,2020,0,98136
299500.0,4,2.25,1600,15312,1.0,4,1080,520,98045
349950.0,4,2.5,2090,5289,2.0,3,2090,0,98058
575000.0,3,1.75,1720,5956,2.0,3,1720,0,98033
286000.0,3,2.5,1680,5000,2.0,3,1680,0,98023
335000.0,3,2.0,1210,9926,1.0,4,1210,0,98006
265000.0,3,2.25,2540,7216,2.0,3,2540,0,98023
241400.0,3,2.0,1420,9828,1.0,4,1420,0,98010
309950.0,4,1.75,1450,10074,1.0,4,1450,0,98058
345000.0,3,2.25,1920,9672,2.0,4,1920,0,98074
625000.0,3,2.25,1920,9672,2.0,4,1920,0,98074
660000.0,4,2.5,2510,4543,2.0,3,2510,0,98075
770000.0,3,2.0,2350,5700,1.5,4,1810,540,98112
259950.0,3,1.5,1350,7827,1.0,4,1350,0,98030
395000.0,3,2.0,1590,10229,1.0,3,1590,0,98034
276500.0,4,1.75,1400,6650,1.5,4,1400,0,98168
325000.0,3,2.5,2220,6049,2.0,4,2220,0,98031
336000.0,3,2.5,2110,4549,2.0,4,2110,0,98042
286900.0,3,2.25,1720,17235,1.0,4,1440,280,98042
263000.0,3,1.75,1410,8100,2.0,3,1410,0,98038
305000.0,3,2.5,1610,3516,2.0,3,1610,0,98055
289950.0,3,2.25,1740,9370,1.0,3,1390,350,98198
339000.0,4,2.0,2470,5080,1.5,3,1970,500,98106
583000.0,3,2.5,1790,8144,2.0,3,1790,0,98074
550000.0,3,2.5,2290,6328,2.0,3,2290,0,98146
600000.0,3,2.5,2320,52272,1.5,3,2320,0,98075
265000.0,3,2.5,1530,6000,2.0,4,1530,0,98038
347500.0,3,1.5,1180,8353,1.0,3,1180,0,98155
397500.0,4,2.5,2570,7859,2.0,3,2570,0,98038
225000.0,3,1.5,1250,7500,1.0,3,1250,0,98030
720000.0,4,2.5,2440,34290,2.0,3,2440,0,98053
368250.0,3,2.5,2150,7484,2.0,3,2150,0,98074
580000.0,3,2.5,2150,7484,2.0,3,2150,0,98074
215000.0,4,2.5,2130,4496,2.0,3,2130,0,98001
465000.0,3,2.25,1450,1540,2.0,3,1180,270,98107
640000.0,4,2.0,2310,31850,1.5,4,2310,0,98072
638250.0,4,2.5,2460,8029,2.0,3,2460,0,98074
375000.0,4,2.0,1620,4600,2.0,3,1620,0,98108
842000.0,4,1.75,2170,9525,1.0,3,2170,0,98040
730000.0,3,2.5,2160,8809,1.0,3,1540,620,98103
265000.0,4,2.0,1600,10160,1.0,4,1600,0,98022
550000.0,4,2.5,2050,8683,2.0,3,2050,0,98074
270000.0,3,1.5,1540,13475,1.0,4,1540,0,98059
810000.0,3,2.0,1760,16928,1.0,3,1760,0,98004
665000.0,3,2.5,1730,3000,2.0,3,1730,0,98103
327500.0,4,1.75,1650,7800,1.0,3,1650,0,98058
424000.0,3,2.5,2200,34680,2.0,3,2200,0,98092
445000.0,3,1.75,1490,10844,1.0,3,1210,280,98008
450000.0,3,2.5,1530,762,2.0,3,1050,480,98119
460000.0,4,2.5,2080,17532,2.0,3,2080,0,98059
272000.0,4,2.25,1880,6160,2.0,3,1880,0,98023
535000.0,3,2.5,2510,5544,2.0,3,2510,0,98053
325000.0,3,2.5,2130,12245,2.0,3,2130,0,98042
420200.0,3,1.75,1320,7280,1.0,3,1320,0,98034
720168.0,4,2.25,2120,3794,2.0,4,1420,700,98117
569500.0,4,2.5,2340,8248,2.0,3,2340,0,98074
524950.0,3,1.75,1890,3825,1.0,3,1290,600,98117
338500.0,4,2.5,2390,6111,2.0,3,2390,0,98030
386000.0,4,2.25,2050,9583,2.0,3,1770,280,98198
278000.0,3,2.0,1230,7789,1.0,3,1230,0,98042
585000.0,3,2.5,2050,11690,2.0,4,2050,0,98059
616000.0,4,1.75,1700,5846,1.0,3,1700,0,98199
203000.0,3,1.75,1610,9000,1.0,4,1100,510,98092
572500.0,3,2.5,2490,7589,2.0,3,2490,0,98056
254000.0,4,2.0,1510,4235,1.0,3,1510,0,98108
899000.0,3,2.5,1950,3730,2.0,3,1950,0,98033
512500.0,3,1.75,1610,7200,1.0,3,1180,430,98007
540000.0,3,1.75,2050,9580,1.0,3,1400,650,98074
275000.0,3,1.5,1390,48257,1.0,3,1390,0,98024
342400.0,3,2.25,1180,9630,2.0,3,1180,0,98028
449950.0,3,2.0,1880,3048,2.0,4,1880,0,98122
651100.0,4,2.5,2310,5526,2.0,3,2310,0,98074
345950.0,3,2.5,2110,4118,2.0,3,2110,0,98042
295000.0,4,2.5,2350,8906,2.0,3,2350,0,98031
434975.0,3,2.25,1590,9960,1.0,3,1060,530,98155
513000.0,3,2.5,1810,4592,2.0,3,1810,0,98029
360000.0,3,1.75,1900,11407,1.0,3,1900,0,98155
416500.0,4,2.0,2280,39848,2.0,4,2280,0,98070
230000.0,4,1.5,1520,8800,1.0,4,1520,0,98002
497000.0,3,1.5,2240,28750,1.0,3,1620,620,98034
250000.0,3,2.25,1920,7738,1.0,3,1520,400,98148
390000.0,4,2.5,1840,15496,2.0,3,1840,0,98059
415000.0,3,2.75,2080,9600,1.0,3,2080,0,98028
575000.0,3,2.0,2168,4000,1.5,3,2168,0,98105
677000.0,4,2.0,2180,6000,1.5,3,2060,120,98144
325000.0,4,2.5,2200,7719,2.0,3,2200,0,98030
212500.0,3,1.5,1270,7128,1.0,4,1270,0,98198
663000.0,3,2.5,2480,37843,1.5,4,2480,0,98070
515000.0,4,2.5,1850,9248,2.0,3,1850,0,98028
410000.0,3,2.25,2200,16921,2.0,3,2200,0,98038
387000.0,3,2.25,1445,1606,2.0,3,1300,145,98027
268643.0,4,2.25,1810,9240,2.0,3,1810,0,98055
320000.0,4,2.5,2050,8424,2.0,4,2050,0,98022
376000.0,3,2.0,1540,1827,2.0,3,1540,0,98029
285000.0,4,2.5,2200,9397,2.0,3,2200,0,98001
510000.0,4,2.5,2440,10423,1.0,3,2440,0,98034
807000.0,3,2.5,1940,4000,2.0,4,1940,0,98199
315000.0,4,2.5,1780,6000,2.0,3,1780,0,98038
637000.0,3,2.25,2200,7355,2.0,4,2200,0,98052
325900.0,4,2.5,2320,6270,2.0,3,2320,0,98042
215000.0,4,2.5,1700,6675,2.0,3,1700,0,98038
315000.0,4,2.5,1700,6675,2.0,3,1700,0,98038
509007.0,3,1.75,1800,7620,1.0,3,1350,450,98177
205000.0,3,1.75,1290,7210,1.0,3,1290,0,98023
275000.0,3,1.5,1900,9737,1.0,4,1200,700,98031
685000.0,3,1.75,1480,7000,1.0,3,1480,0,98122
560000.0,4,2.25,1950,9800,1.0,3,1330,620,98033
458500.0,3,1.75,1250,9605,1.0,3,1250,0,98008
316500.0,4,2.5,2150,6807,2.0,4,2150,0,98031
524950.0,3,1.75,1750,3250,1.5,4,1230,520,98117
780000.0,3,1.75,2430,4524,1.5,4,1830,600,98103
330000.0,4,2.5,1820,3905,2.0,3,1820,0,98019
435000.0,3,2.0,1610,6911,1.0,3,1260,350,98034
252000.0,3,2.5,1680,8284,2.0,3,1680,0,98038
499500.0,3,2.5,2520,53143,1.5,3,2520,0,98019
294000.0,4,2.5,2040,7800,2.0,3,2040,0,98168
272000.0,4,2.0,1780,19843,1.0,3,1780,0,98058
390000.0,3,2.5,2240,10800,2.0,3,2240,0,98028
500000.0,3,1.75,1570,8530,1.0,4,1190,380,98033
575000.0,3,2.5,1870,3485,2.0,3,1870,0,98029
487600.0,4,2.5,2340,12080,2.0,3,2340,0,98019
450000.0,4,1.75,1520,5250,1.0,3,1520,0,98199
550000.0,3,1.75,1840,8086,1.0,4,1840,0,98052
330000.0,4,2.0,1750,5202,1.0,4,1070,680,98108
750000.0,4,1.75,2100,6613,2.0,3,2100,0,98116
321000.0,4,2.5,2430,5366,2.0,3,2430,0,98092
245000.0,4,2.0,1830,10416,1.0,3,1370,460,98146
675000.0,4,2.5,2560,36601,2.0,4,2560,0,98075
295000.0,3,1.75,1930,13350,1.0,3,1930,0,98023
400000.0,4,2.0,1420,9301,1.0,4,1420,0,98008
415000.0,3,1.5,1360,1795,2.0,3,1360,0,98199
781000.0,4,2.5,2590,8571,2.0,3,2590,0,98052
329950.0,4,2.5,1920,4600,2.0,3,1920,0,98038
600000.0,4,2.5,2310,3866,2.0,3,2310,0,98029
670000.0,4,2.5,2095,4569,2.0,3,2095,0,98052
320000.0,3,2.25,1880,7350,1.0,3,1390,490,98058
540000.0,3,2.5,1950,13227,2.0,4,1950,0,98034
239000.0,4,1.75,1500,12560,1.0,4,1000,500,98002
495000.0,3,2.25,2100,3000,2.0,3,2100,0,98144
495000.0,3,1.5,2240,13288,1.0,3,2240,0,98033
464950.0,4,2.25,2350,36116,1.0,4,2350,0,98042
320000.0,4,2.5,1940,7040,2.0,3,1940,0,98092
555000.0,4,1.75,2260,11000,1.0,3,1620,640,98008
247200.0,3,1.75,1370,8719,1.0,3,1370,0,98042
250000.0,3,2.25,1960,7414,1.0,3,1490,470,98023
590300.0,3,1.5,1470,7200,2.0,4,1470,0,98118
277500.0,3,2.25,1820,19602,1.0,4,1820,0,98001
289200.0,3,2.25,1760,7023,2.0,3,1760,0,98019
699000.0,3,2.5,2580,8154,1.0,3,2090,490,98177
350000.0,3,2.5,2100,3574,2.0,3,1690,410,98019
543000.0,3,2.5,2090,7640,1.0,3,1360,730,98133
325000.0,3,2.5,1570,3143,2.0,3,1570,0,98019
780000.0,3,2.5,2110,9773,1.0,3,2110,0,98006
524400.0,4,1.75,1990,12950,1.0,4,1850,140,98006
260000.0,3,2.0,1630,8018,1.0,3,1630,0,98001
420000.0,4,2.5,2480,8626,2.0,3,2480,0,98001
226000.0,3,1.75,1490,6269,1.0,4,990,500,98056
407450.0,3,2.0,1810,10860,1.0,3,1810,0,98053
239975.0,3,2.5,1820,7242,1.0,3,1220,600,98188
450000.0,4,1.75,2190,11625,1.0,4,2020,170,98146
300000.0,3,2.25,1780,10395,1.0,3,1780,0,98058
525000.0,3,1.75,1600,6120,1.5,3,1600,0,98115
287000.0,3,2.25,1490,9600,1.0,4,1170,320,98019
435000.0,3,2.25,1380,3015,2.0,3,1380,0,98052
626700.0,3,1.5,1410,3600,1.0,3,1410,0,98109
352000.0,4,1.5,1440,8680,1.5,3,1440,0,98178
560000.0,3,2.0,1840,14985,1.0,3,1840,0,98033
354000.0,3,1.75,1340,6300,1.0,3,1340,0,98034
670000.0,4,2.5,2570,9086,2.0,3,2570,0,98074
300000.0,3,1.75,1810,21138,1.0,4,1240,570,98058
639000.0,4,2.5,2500,8540,2.0,3,2500,0,98029
450000.0,3,2.0,1680,4886,2.0,3,1180,500,98118
350000.0,4,2.5,2260,13755,1.0,4,2260,0,98042
594950.0,4,2.25,2380,35008,1.0,3,2380,0,98075
450000.0,4,2.5,2070,3982,2.0,3,2070,0,98065
402000.0,4,2.25,1790,7311,2.0,3,1790,0,98056
314000.0,3,1.75,1620,9600,1.0,4,1620,0,98059
287000.0,4,2.0,1340,8190,1.0,4,1340,0,98146
575000.0,3,2.25,1700,3333,1.5,3,1100,600,98117
510000.0,4,2.5,1840,7800,1.0,3,1240,600,98177
364000.0,4,1.75,2010,8625,1.0,4,1340,670,98133
215000.0,3,2.0,1280,6994,1.0,3,1280,0,98038
292000.0,3,2.25,1780,9720,1.0,3,1280,500,98059
289950.0,3,2.0,1670,7757,1.0,3,1670,0,98030
257500.0,4,1.5,1360,9323,1.0,4,1360,0,98023
380000.0,3,2.5,1840,6985,1.0,3,1290,550,98133
269500.0,3,1.75,1840,7412,1.0,4,1240,600,98031
375000.0,4,1.5,1430,7232,1.5,3,1430,0,98125
200000.0,3,2.0,1170,10051,1.0,4,1170,0,98198
574000.0,3,2.5,2380,6832,2.0,3,2380,0,98065
271950.0,3,1.5,1220,8400,1.0,4,1220,0,98006
334000.0,4,2.5,2310,6200,2.0,3,2310,0,98092
332500.0,4,2.0,1440,4855,2.0,4,1440,0,98144
560000.0,4,1.5,1810,6000,1.0,3,1350,460,98136
359000.0,4,1.75,1680,9244,2.0,3,1680,0,98166
300000.0,3,2.25,1660,5128,2.0,3,1660,0,98019
273000.0,3,2.5,1650,5994,2.0,4,1650,0,98030
670000.0,3,2.5,1420,1438,2.0,3,1280,140,98102
530000.0,4,2.25,2240,8376,1.0,3,1740,500,98074
533000.0,3,2.5,2060,4812,2.0,3,2060,0,98029
353500.0,3,2.5,2020,4845,2.0,3,2020,0,98038
675000.0,4,1.75,2440,7475,1.0,4,2040,400,98052
499000.0,3,2.5,1720,5940,1.0,4,1000,720,98052
320000.0,4,2.5,2570,4865,2.0,3,2570,0,98038
277000.0,3,2.25,1610,11920,1.0,4,1110,500,98032
265953.0,3,1.75,1470,13068,1.0,4,1470,0,98092
545000.0,3,2.25,1670,6240,1.0,4,1240,430,98008
535000.0,3,2.5,1850,10109,2.0,3,1850,0,98034
319950.0,4,2.5,2020,7200,1.5,4,2020,0,98065
475000.0,3,1.75,1320,7840,1.0,3,1320,0,98007
430000.0,3,2.5,2000,35438,2.0,3,2000,0,98027
310650.0,3,1.75,1510,12408,1.0,4,1510,0,98059
580000.0,4,2.5,2150,5000,2.0,3,2150,0,98115
580000.0,3,2.25,1900,3960,1.5,3,1200,700,98122
239950.0,3,2.25,1560,8280,2.0,4,1560,0,98001
470000.0,4,2.5,1990,30083,2.0,3,1990,0,98155
289000.0,3,1.5,1970,22486,1.0,4,1970,0,98058
376000.0,3,2.25,1470,9140,2.0,3,1470,0,98133
325000.0,3,1.75,1780,13095,1.0,4,1780,0,98042
415000.0,4,2.5,2230,5743,2.0,3,2230,0,98019
372000.0,3,2.5,1920,15260,2.0,3,1920,0,98019
240000.0,3,1.5,1290,8366,1.0,3,1020,270,98168
455850.0,3,2.25,1820,6000,1.0,4,1120,700,98108
400000.0,3,1.75,1530,10731,1.0,3,1530,0,98028
490000.0,3,2.5,2040,9622,2.0,3,2040,0,98045
260000.0,3,2.5,1600,2244,2.0,3,1600,0,98056
440000.0,3,2.0,1650,6408,2.0,4,1650,0,98052
306500.0,3,2.5,1970,6291,2.0,4,1970,0,98042
380000.0,3,2.0,1470,1656,2.0,3,1310,160,98126
494000.0,4,2.5,1830,7345,1.0,4,1540,290,98177
317500.0,4,1.5,1730,7700,1.0,4,1010,720,98059
670000.0,4,2.5,2110,7291,2.0,4,2110,0,98033
264950.0,3,1.5,1400,10853,1.0,4,1400,0,98055
384000.0,3,2.5,1540,1564,2.0,3,1300,240,98144
817000.0,3,1.5,2310,3360,1.5,3,1790,520,98119
320000.0,4,1.75,1730,9520,1.0,4,1730,0,98059
445800.0,4,2.25,2070,39446,1.0,3,1470,600,98155
251100.0,4,2.5,1790,5257,2.0,3,1790,0,98030
435000.0,3,1.75,1750,16748,1.0,3,1330,420,98072
555000.0,3,1.75,1570,15500,1.0,4,1570,0,98052
605000.0,4,2.25,2260,11900,2.0,3,2260,0,98074
379500.0,3,2.25,1830,25641,2.0,3,1830,0,98059
324950.0,3,2.5,1560,9600,1.0,3,1210,350,98188
470000.0,3,1.75,2290,14800,1.0,3,1620,670,98155
279000.0,3,1.75,1750,9623,1.0,3,1150,600,98198
315000.0,3,1.75,1660,37642,1.0,4,1660,0,98022
529000.0,3,2.5,1880,4499,2.0,3,1880,0,98029
481500.0,3,2.25,1840,10500,2.0,3,1840,0,98034
455000.0,3,2.25,1790,7500,1.0,3,1390,400,98034
327500.0,4,2.25,2240,9600,2.0,3,2240,0,98032
445000.0,4,2.75,2320,12368,1.0,3,1670,650,98133
257950.0,3,1.75,1370,5858,1.0,3,1370,0,98198
245000.0,3,2.5,1610,7223,2.0,3,1610,0,98030
330000.0,3,1.75,1850,14986,2.0,3,1850,0,98059
279950.0,4,2.75,2420,8700,1.5,4,2420,0,98002
284000.0,3,2.25,1580,7034,1.0,4,1180,400,98038
278500.0,4,2.5,1940,6206,2.0,3,1940,0,98023
517500.0,3,1.75,1810,10625,1.0,3,1370,440,98027
550000.0,3,1.75,1680,4800,1.0,4,1400,280,98126
286000.0,4,2.5,2060,16000,2.0,3,2060,0,98001
449950.0,3,2.25,1610,5159,2.0,3,1610,0,98029
259000.0,4,1.5,1490,7560,2.0,3,1490,0,98198
340000.0,3,2.25,1900,8125,1.0,3,1540,360,98058
377000.0,3,1.75,1680,7389,1.0,3,1150,530,98056
595000.0,3,2.0,1530,6773,1.0,4,1530,0,98033
260000.0,3,1.75,1680,8725,1.0,3,1240,440,98023
320000.0,3,2.0,1550,34175,1.5,3,1550,0,98045
503500.0,3,2.5,1810,1750,2.0,3,1350,460,98199
653000.0,3,2.5,2290,3475,2.0,3,2290,0,98029
525000.0,3,1.5,1560,9350,1.0,4,1220,340,98052
442500.0,4,2.25,2490,8700,1.0,3,1890,600,98155
525000.0,4,1.75,1710,10440,1.0,4,1710,0,98006
425500.0,4,1.75,1520,10630,1.0,4,1520,0,98034
245000.0,3,2.25,1700,8100,1.0,3,1200,500,98038
284000.0,4,2.5,2000,5390,2.0,3,2000,0,98042
483300.0,4,2.0,1210,11100,1.0,4,1210,0,98006
355000.0,4,2.5,2130,9268,2.0,4,2130,0,98092
274950.0,3,2.25,1570,8767,1.0,3,1180,390,98038
219950.0,3,2.25,1500,7615,1.0,3,1150,350,98023
690000.0,3,2.5,1300,5150,1.5,4,1300,0,98117
250800.0,3,1.75,1290,4000,1.0,3,1170,120,98106
557500.0,3,2.0,2510,35255,1.0,3,2510,0,98038
815000.0,4,1.5,2060,16110,1.0,4,2060,0,98004
535000.0,3,2.5,2110,8164,2.0,3,2110,0,98056
255000.0,3,2.0,1590,8670,1.0,3,1590,0,98042
560000.0,4,2.0,2720,8819,2.0,3,2240,480,98003
254000.0,3,2.25,1660,8188,2.0,4,1660,0,98042
585000.0,4,2.5,1860,8117,1.0,4,1460,400,98008
225000.0,3,2.0,1400,7384,1.0,3,1150,250,98058
295000.0,3,2.0,1400,7384,1.0,3,1150,250,98058
567500.0,3,1.75,2570,14033,1.0,4,2570,0,98166
442500.0,4,2.25,1970,7902,1.0,3,1310,660,98125
544900.0,3,2.5,1990,4936,2.0,3,1990,0,98075
557500.0,4,2.5,2390,38258,2.0,3,2390,0,98072
532500.0,3,2.5,2160,7500,1.0,3,1430,730,98074
530000.0,3,2.5,2030,10958,2.0,3,2030,0,98052
346100.0,3,2.5,1400,2036,2.0,3,1400,0,98136
260000.0,4,2.25,2320,16800,2.0,4,2320,0,98092
318400.0,4,2.5,1820,6916,2.0,3,1820,0,98038
498500.0,4,2.5,1910,7172,2.0,3,1910,0,98155
200000.0,3,2.0,1430,7905,1.0,4,1430,0,98092
475000.0,3,2.5,1920,4534,2.0,3,1920,0,98034
573000.0,4,2.25,2150,9520,2.0,4,2150,0,98052
330000.0,3,2.5,1660,2890,2.0,3,1660,0,98108
280000.0,3,2.0,1280,7633,1.0,3,1280,0,98038
580000.0,4,1.5,1780,5100,1.0,3,1320,460,98115
301000.0,3,1.75,1840,7200,1.0,4,1220,620,98055
366000.0,3,2.5,2370,4375,2.0,3,2370,0,98038
303000.0,4,2.5,2100,6783,2.0,3,2100,0,98042
432000.0,3,2.25,1470,1578,2.0,3,1090,380,98136
500000.0,3,1.5,1190,4750,1.0,3,970,220,98107
536000.0,3,1.75,1530,8503,1.0,4,1150,380,98033
550000.0,3,2.25,1980,40887,1.0,4,1980,0,98052
260000.0,3,1.75,1710,6400,1.0,4,1240,470,98023
740000.0,3,2.5,2200,3000,2.0,3,1530,670,98109
675000.0,3,1.5,1710,4000,2.0,3,1710,0,98116
267500.0,3,1.75,1650,7807,1.0,3,1650,0,98030
460000.0,3,2.0,1860,7232,1.0,3,1320,540,98125
445000.0,3,2.5,2250,9608,2.0,3,2250,0,98045
370000.0,4,2.5,2130,4750,2.0,3,2130,0,98058
290000.0,3,1.75,1280,10716,1.0,4,1280,0,98059
204950.0,4,1.75,1740,9344,1.0,3,1180,560,98023
472500.0,3,2.5,1650,3711,2.0,3,1650,0,98052
575575.0,3,1.75,1516,2897,1.0,3,998,518,98103
340000.0,4,2.5,2090,4200,2.0,3,2090,0,98038
601000.0,4,2.5,2090,6906,2.0,4,2090,0,98029
470000.0,3,2.5,2070,8581,2.0,3,2070,0,98059
550000.0,3,1.75,1880,45738,1.0,4,1410,470,98072
242550.0,4,2.5,2060,7720,2.0,3,2060,0,98023
367500.0,3,1.5,1410,9647,1.0,3,1410,0,98177
187000.0,3,1.5,1280,4452,2.0,3,1280,0,98002
326000.0,3,2.75,1720,28000,1.0,4,1720,0,98058
340000.0,3,2.75,1720,28000,1.0,4,1720,0,98058
400000.0,3,2.0,1350,7216,1.0,3,1350,0,98177
471000.0,3,1.75,1640,10123,1.0,3,1340,300,98011
639500.0,4,2.25,2330,8994,2.0,3,2330,0,98052
580379.0,4,2.75,2240,27820,1.5,4,2240,0,98075
265000.0,3,2.25,1750,9298,1.0,4,1410,340,98058
750000.0,4,2.5,2540,6491,2.0,3,2540,0,98008
350000.0,3,2.75,2370,4632,2.0,3,2370,0,98038
442500.0,3,1.75,1600,10280,1.0,3,1050,550,98034
659000.0,3,2.5,2510,6320,2.0,3,2510,0,98075
275000.0,3,1.5,1180,10277,1.0,3,1180,0,98045
424000.0,3,2.5,1820,7500,2.0,3,1820,0,98052
615000.0,4,1.75,2270,9830,1.0,4,2270,0,98005
279000.0,4,2.0,1560,7569,1.5,4,1560,0,98058
535100.0,3,2.25,2070,7207,1.0,3,1720,350,98177
535900.0,3,2.25,1880,10880,1.0,3,1480,400,98008
359000.0,3,2.25,1990,4331,2.0,3,1990,0,98056
505000.0,3,2.5,2100,5824,2.0,3,2100,0,98065
369950.0,3,1.75,1640,4860,1.0,3,1200,440,98125
350000.0,3,2.25,1860,8378,2.0,3,1860,0,98038
295000.0,3,1.75,1500,15246,1.0,3,1500,0,98070
620000.0,3,1.75,1680,28046,1.0,3,1180,500,98177
385000.0,4,2.75,2960,10454,1.0,3,2360,600,98198
769000.0,4,2.5,2440,6733,2.0,3,2440,0,98074
468000.0,4,2.5,2150,8165,1.0,3,1430,720,98177
520000.0,4,2.5,2490,34947,2.0,3,2150,340,98027
235000.0,4,1.75,1450,8891,1.5,3,1180,270,98168
640000.0,3,1.5,1960,4080,1.5,3,1960,0,98115
267000.0,3,1.75,1440,10920,1.0,4,1440,0,98030
703300.0,3,2.0,1980,3525,1.5,4,1590,390,98117
265000.0,4,1.5,1580,8468,2.0,4,1580,0,98001
617950.0,4,2.5,2410,7950,2.0,3,2410,0,98034
269950.0,3,1.75,1400,7735,1.0,4,1400,0,98038
275000.0,3,1.5,1510,16200,1.0,3,1510,0,98031
247000.0,3,2.25,1580,7941,2.0,4,1580,0,98023
204555.0,3,1.75,1260,15000,1.5,4,1260,0,98092
432000.0,3,2.0,2190,13673,1.0,4,2190,0,98042
175000.0,3,1.75,1230,13056,1.0,4,1230,0,98001
556300.0,4,2.5,2030,7140,1.0,4,1400,630,98008
385000.0,4,1.75,1660,10757,1.0,3,1000,660,98056
350000.0,4,2.25,2390,13002,2.0,3,2390,0,98023
277000.0,4,2.5,1850,5880,2.0,3,1850,0,98092
269950.0,3,2.25,1660,7003,2.0,3,1660,0,98030
319000.0,4,2.25,2390,7350,2.0,3,2390,0,98023
809000.0,4,1.75,1790,8372,1.0,4,1340,450,98033
480000.0,3,2.0,1580,7400,1.0,3,1050,530,98052
292000.0,3,2.5,1950,7421,2.0,3,1950,0,98038
398500.0,4,2.5,2250,6064,2.0,3,2250,0,98056
585000.0,4,2.5,2330,45860,2.0,3,2330,0,98075
560000.0,3,2.5,2020,11935,1.0,4,2020,0,98052
502550.0,3,1.75,1770,7875,1.0,4,1170,600,98008
375000.0,3,2.5,1950,6871,2.0,3,1950,0,98155
485000.0,3,2.5,1650,4218,2.0,3,1650,0,98075
275000.0,3,2.5,1560,4244,2.0,3,1560,0,98038
256400.0,3,1.5,1490,7800,1.0,3,1010,480,98003
203000.0,3,1.5,1200,9120,1.0,3,1000,200,98055
473975.0,3,2.5,2330,3610,2.0,3,2330,0,98074
320000.0,3,1.75,2000,9760,1.0,4,1400,600,98058
269500.0,4,2.25,1700,7056,2.0,3,1700,0,98001
220000.0,3,1.75,1460,7226,1.0,3,1460,0,98198
657500.0,4,1.5,1910,5000,1.5,3,1610,300,98105
332500.0,4,2.5,2220,4720,2.0,3,2220,0,98038
340000.0,3,2.0,1410,10015,1.0,3,1410,0,98045
515055.0,4,2.5,2400,8320,2.0,3,2400,0,98045
450000.0,3,1.75,1560,8968,1.0,4,1560,0,98008
299000.0,3,2.5,1850,4600,2.0,3,1850,0,98058
294000.0,4,2.25,2190,3746,2.0,3,2190,0,98038
286651.0,3,2.5,1830,4997,2.0,3,1830,0,98001
334950.0,4,1.75,1700,40973,1.0,3,1700,0,98031
775000.0,3,1.75,1640,18730,1.5,4,1640,0,98004
470101.0,4,2.5,2320,7800,2.0,3,2320,0,98028
195000.0,3,1.5,1200,7800,1.0,4,1200,0,98002
525000.0,4,1.75,1650,8560,1.0,3,1650,0,98052
280000.0,3,1.5,1370,11400,2.0,3,1370,0,98045
270000.0,3,2.5,1770,8640,1.0,3,1420,350,98001
312000.0,4,2.5,1830,5175,2.0,3,1830,0,98038
439000.0,3,2.25,1830,13477,1.0,4,1170,660,98034
425000.0,4,2.0,1490,5300,1.0,3,1110,380,98144
305000.0,3,2.25,1646,12414,2.0,3,1646,0,98038
327500.0,3,2.25,2310,7200,2.0,3,2310,0,98031
272000.0,3,1.5,1380,11760,1.0,4,1380,0,98055
543000.0,3,1.5,1710,8364,2.0,3,1710,0,98136
400000.0,3,2.5,1450,8064,1.0,3,1450,0,98074
235000.0,4,1.5,1760,6150,1.5,3,1760,0,98031
763000.0,3,2.0,1360,8752,1.0,4,1360,0,98033
349900.0,4,2.5,2290,8796,2.0,3,2290,0,98198
655000.0,3,1.75,1800,5102,1.0,3,1170,630,98199
355000.0,3,2.25,1980,7200,1.0,3,1300,680,98177
596000.0,3,2.5,1730,2631,2.0,3,1730,0,98005
428040.0,3,2.5,2150,9266,2.0,3,2150,0,98028
345000.0,3,1.75,1240,38095,1.0,3,1240,0,98053
389800.0,3,1.75,1880,12821,1.0,3,1880,0,98155
475000.0,3,1.75,1890,7560,1.0,3,1430,460,98034
569000.0,4,2.25,2250,41688,2.0,3,2250,0,98053
532000.0,3,2.5,1830,8022,2.0,3,1830,0,98074
225000.0,3,2.0,1610,8400,1.0,3,1610,0,98022
499000.0,3,2.5,2090,8505,2.0,3,2090,0,98177
420000.0,3,1.75,1510,6360,1.0,4,1510,0,98133
319990.0,4,2.5,2120,5293,2.0,3,2120,0,98031
265000.0,3,2.0,1850,16535,1.0,3,1850,0,98014
635000.0,4,2.5,2500,10215,2.0,3,2500,0,98075
280500.0,4,2.5,1890,6962,2.0,3,1890,0,98092
196500.0,3,2.0,1310,7000,1.0,4,1310,0,98023
550000.0,3,2.5,1980,9061,2.0,4,1980,0,98074
240000.0,3,1.75,1540,6687,1.0,3,1200,340,98022
640000.0,3,2.5,2580,7500,2.0,3,2580,0,98116
316000.0,4,2.5,2010,7226,2.0,3,2010,0,98092
299000.0,4,2.0,2320,12000,1.0,3,1720,600,98108
215000.0,4,1.75,1630,8000,1.0,3,1630,0,98031
275000.0,3,2.25,1620,6415,2.0,4,1620,0,98038
648000.0,4,2.25,2170,8240,2.0,4,2170,0,98006
415000.0,4,2.5,2150,8173,2.0,3,2150,0,98059
750000.0,3,1.75,1590,8285,1.0,4,1590,0,98004
246000.0,3,1.75,1390,7399,1.0,4,1390,0,98031
217000.0,3,2.0,1690,6750,1.0,3,1210,480,98023
583000.0,3,2.5,2600,5100,2.0,3,2600,0,98056
594000.0,4,1.75,2140,8000,1.0,4,1410,730,98007
303100.0,3,1.5,1640,5650,1.0,3,1640,0,98178
430000.0,3,1.75,1720,15225,1.0,4,1020,700,98075
325000.0,3,2.5,2000,7205,2.0,3,2000,0,98003
359500.0,3,2.5,2070,4689,2.0,3,2070,0,98038
433000.0,3,2.0,1920,7200,1.0,3,1300,620,98028
513000.0,4,2.0,2090,4000,1.0,3,1480,610,98107
225000.0,3,2.25,1470,6808,1.0,3,1160,310,98023
465000.0,3,1.5,1460,9879,1.0,3,1460,0,98008
725000.0,3,2.0,2110,5800,1.5,4,1990,120,98103
413900.0,4,2.25,1770,5236,2.0,3,1770,0,98056
199950.0,3,1.5,1510,6600,1.0,3,1510,0,98168
870000.0,3,1.5,2420,5000,2.0,4,2200,220,98103
466750.0,4,2.0,1730,9139,2.0,3,1730,0,98125
802500.0,4,2.25,1950,7000,1.0,3,1450,500,98118
460000.0,3,2.0,1200,7320,1.0,3,1200,0,98115
567000.0,3,2.5,2070,10908,2.0,3,2070,0,98029
209950.0,3,1.75,1570,15570,1.0,3,1570,0,98023
365000.0,3,2.5,2200,9696,2.0,3,2200,0,98031
631000.0,4,2.0,1930,3240,1.5,4,1930,0,98122
584000.0,3,2.5,1790,3962,2.0,3,1790,0,98117
667000.0,3,1.5,1720,8100,2.0,3,1720,0,98107
430000.0,3,2.0,1730,9000,1.0,3,1370,360,98027
475000.0,3,2.5,2280,3710,1.0,3,1550,730,98072
715000.0,3,2.5,2550,13458,2.0,3,2550,0,98006
328000.0,4,1.75,1990,7194,1.0,4,1400,590,98058
239999.0,3,2.75,1740,8436,1.0,3,1140,600,98003
225000.0,3,2.0,1460,7740,1.0,3,1460,0,98003
241000.0,3,2.0,1770,7000,1.0,3,1770,0,98001
307550.0,4,2.5,1980,5909,2.0,3,1980,0,98031
517500.0,3,2.5,1810,4332,2.0,3,1810,0,98029
295000.0,3,2.0,1380,8682,1.0,4,1380,0,98148
560000.0,4,1.5,1810,3400,2.0,3,1810,0,98112
350000.0,3,1.75,1480,9375,1.0,4,1480,0,98146
481000.0,4,2.5,2286,8269,2.0,3,2286,0,98056
477000.0,3,2.5,1740,4960,2.0,3,1740,0,98029
318200.0,3,2.5,1990,3644,2.0,3,1990,0,98038
289000.0,3,2.0,1680,8424,1.0,3,1680,0,98022
263000.0,3,1.75,1570,7775,2.0,3,1570,0,98031
485000.0,3,1.75,1650,9500,1.0,3,1650,0,98052
309000.0,3,2.5,1450,11480,2.0,3,1450,0,98014
221000.0,3,2.25,1640,7350,1.0,3,1140,500,98003
700000.0,3,2.5,2030,8398,2.0,4,2030,0,98008
680000.0,3,2.5,1610,8064,1.0,4,1160,450,98033
470000.0,3,1.5,1510,8000,1.0,4,1510,0,98007
284000.0,3,2.5,2150,9375,1.0,3,1550,600,98188
295000.0,3,2.5,1660,8125,1.0,3,1150,510,98148
555000.0,4,2.5,2160,10987,1.0,4,1440,720,98074
240000.0,3,2.25,1460,5818,1.0,3,1140,320,98023
419900.0,3,1.5,1450,7000,1.0,3,1450,0,98007
528000.0,3,2.0,1560,6300,1.0,3,1560,0,98126
738950.0,4,2.75,2260,12005,1.0,4,2260,0,98005
215000.0,3,1.5,1240,9405,1.0,4,1240,0,98042
500000.0,3,1.75,1700,6120,1.0,3,1700,0,98116
519900.0,4,2.0,1820,9350,1.0,4,1820,0,98052
314500.0,3,1.75,1870,12381,1.0,4,1870,0,98003
499950.0,3,1.5,1350,9315,1.0,3,1350,0,98052
630000.0,3,2.5,2460,38794,2.0,3,2460,0,98077
360000.0,4,1.5,1720,6417,1.0,3,1720,0,98125
713400.0,3,2.25,1810,9845,1.0,4,1810,0,98040
393000.0,3,2.0,1320,10720,2.0,3,1320,0,98074
725000.0,4,2.5,2490,5170,2.0,4,2490,0,98052
410000.0,4,2.5,2240,4447,2.0,3,2240,0,98059
250000.0,4,2.5,1800,8100,2.0,3,1800,0,98038
430000.0,4,1.75,1570,7650,1.0,3,1100,470,98052
515000.0,3,1.75,1570,10939,1.0,3,1200,370,98052
482500.0,3,2.0,1330,6490,1.0,4,1330,0,98125
835000.0,4,2.75,1550,4000,1.5,3,1550,0,98105
237000.0,3,2.0,1290,7952,1.0,3,1290,0,98030
280017.0,3,2.5,1850,8770,2.0,3,1850,0,98022
436500.0,4,2.5,2290,11173,2.0,4,2290,0,98058
420000.0,3,2.25,1800,9800,1.0,4,1300,500,98028
570000.0,3,1.5,1980,10203,1.0,4,1680,300,98010
260000.0,4,1.75,1650,7276,1.0,3,1010,640,98011
470000.0,4,1.75,1650,7276,1.0,3,1010,640,98011
700000.0,3,2.5,2410,9916,2.0,4,2410,0,98052
249000.0,3,1.75,1520,7500,1.0,3,1520,0,98092
225000.0,3,2.5,1680,6755,2.0,3,1680,0,98092
495000.0,3,2.5,1860,3150,2.0,3,1860,0,98034
280000.0,3,1.75,1480,8165,1.0,4,1480,0,98042
380500.0,3,2.5,1900,7361,2.0,3,1900,0,98055
260000.0,3,1.75,1440,12888,1.0,3,1090,350,98168
410000.0,3,2.0,1400,45738,2.0,4,1400,0,98070
352500.0,4,2.5,2100,10750,1.0,4,2100,0,98023
243500.0,4,2.5,2300,15188,2.0,4,2300,0,98042
292500.0,4,2.5,1860,8709,2.0,3,1860,0,98092
449999.0,4,2.5,1950,4947,2.0,3,1950,0,98056
355000.0,4,2.5,1890,7867,2.0,3,1890,0,98038
456500.0,4,2.5,2580,11780,2.0,3,2580,0,98038
375000.0,4,2.0,1240,3000,1.0,3,1040,200,98122
337500.0,3,2.25,1530,6600,1.0,4,1240,290,98055
300000.0,4,2.25,2080,7700,1.0,3,1450,630,98058
510000.0,3,2.0,1850,9600,1.0,3,1850,0,98011
204000.0,3,1.5,1460,7140,1.0,4,980,480,98031
659500.0,3,1.75,1820,5500,1.0,4,1620,200,98115
395000.0,3,2.5,1630,15200,1.0,3,1120,510,98072
308950.0,4,2.5,1920,8562,2.0,4,1920,0,98022
410000.0,3,2.0,1750,2550,1.0,3,1750,0,98133
508800.0,3,2.0,1720,10098,1.0,4,1140,580,98074
245100.0,3,1.75,1300,7958,1.0,3,1300,0,98092
540000.0,3,2.5,1970,14876,1.0,3,1320,650,98146
415000.0,3,1.5,1740,9046,1.0,3,1740,0,98028
195000.0,3,1.75,1190,14777,1.0,4,1190,0,98023
693000.0,3,2.5,2460,12028,2.0,3,2460,0,98052
620000.0,4,2.25,1530,7845,1.0,4,1030,500,98027
390000.0,3,2.0,1510,10827,2.0,3,1510,0,98052
550000.0,3,2.25,1720,9600,1.0,4,1220,500,98052
279900.0,3,2.0,1410,6600,1.0,4,1410,0,98042
375000.0,4,2.5,1900,9428,2.0,3,1900,0,98028
260000.0,4,2.5,1811,4381,2.0,3,1811,0,98055
348000.0,4,2.5,2720,7697,1.0,4,2120,600,98058
302000.0,4,2.5,1740,7895,2.0,3,1740,0,98001
295000.0,3,2.5,1500,3060,2.0,3,1500,0,98006
330000.0,4,2.0,1180,7275,1.0,3,1180,0,98034
286000.0,4,1.5,1600,5750,2.0,4,1600,0,98118
485000.0,3,2.25,2440,47916,2.0,3,2090,350,98053
263000.0,3,2.5,1720,6847,2.0,3,1720,0,98001
330000.0,3,2.5,1676,18778,2.0,3,1676,0,98014
323000.0,3,1.75,1910,8329,1.0,3,1910,0,98022
500000.0,3,2.0,2050,11454,1.0,3,2050,0,98052
304000.0,3,2.5,1670,5298,2.0,3,1670,0,98042
849000.0,4,2.0,2160,6300,1.5,4,2160,0,98116
907000.0,3,1.5,1340,6000,1.5,3,1340,0,98105
700000.0,3,2.5,2490,23891,2.0,3,2490,0,98053
269500.0,3,2.0,1640,8395,1.0,4,1640,0,98038
269000.0,3,2.25,1420,7297,1.0,3,1130,290,98031
325000.0,3,2.75,1580,4007,2.0,3,1580,0,98019
406000.0,3,1.5,1370,7853,1.0,4,1370,0,98056
295000.0,3,1.75,1940,7500,1.5,4,1940,0,98022
510000.0,3,1.75,1610,11950,1.0,3,1210,400,98052
190000.0,3,2.25,1590,11745,1.0,3,1090,500,98001
740000.0,3,1.5,1630,4080,1.5,4,1630,0,98115
713000.0,3,2.75,2310,1850,2.0,3,2020,290,98027
460000.0,3,1.75,1660,9900,2.0,3,1660,0,98033
880000.0,3,1.75,2070,5000,1.5,3,2070,0,98144
450000.0,3,2.5,1990,3478,2.0,3,1520,470,98199
292500.0,3,2.5,2095,3438,2.0,3,2095,0,98002
360000.0,4,1.75,1750,18810,1.0,3,1220,530,98059
263000.0,3,1.75,1660,7210,1.0,4,1660,0,98032
425000.0,3,2.5,2540,5612,2.0,3,2540,0,98059
679000.0,4,2.75,2100,4480,1.5,4,1780,320,98105
410000.0,3,2.0,1740,9300,1.0,4,1740,0,98166
340000.0,4,2.5,2441,7316,2.0,3,2441,0,98023
450000.0,3,1.5,2060,44866,1.0,3,2060,0,98077
175409.0,4,1.5,1450,5530,1.0,4,1450,0,98042
203000.0,3,1.75,1490,8000,1.0,4,1200,290,98092
583000.0,4,2.5,1840,4011,2.0,3,1840,0,98052
312500.0,4,2.5,2160,8755,2.0,3,2160,0,98030
605000.0,4,2.25,1750,6120,1.0,3,1150,600,98115
325000.0,3,2.25,2450,49658,1.0,3,1770,680,98045
630000.0,3,1.75,1940,7306,1.0,3,1470,470,98052
489950.0,3,1.75,2480,10804,1.0,3,1800,680,98177
550000.0,3,2.25,2120,18255,1.0,3,1590,530,98074
237000.0,3,2.0,1710,7920,1.0,3,1260,450,98003
390000.0,3,2.5,1690,10113,1.0,3,1310,380,98028
665000.0,3,2.5,2190,10370,2.0,3,2190,0,98074
615000.0,3,2.5,1490,1410,2.0,3,1300,190,98199
597000.0,4,2.5,2340,7877,2.0,3,2340,0,98125
479000.0,3,1.75,1470,6018,1.0,3,1470,0,98074
292000.0,3,1.75,1650,14633,1.0,4,1650,0,98056
265000.0,3,1.5,1400,6527,1.0,3,1110,290,98166
486000.0,4,2.5,2150,39449,1.0,3,1420,730,98024
259900.0,3,1.75,1690,7953,1.0,3,1690,0,98030
650000.0,4,2.5,2400,7351,2.0,3,2400,0,98029
305000.0,4,2.0,1610,6250,1.0,4,1610,0,98118
272000.0,4,2.5,2070,6175,2.0,3,2070,0,98092
415000.0,3,2.5,2420,10733,2.0,3,2420,0,98038
319000.0,4,2.25,2380,7400,1.0,4,1760,620,98042
325000.0,3,2.5,1830,7585,2.0,4,1830,0,98042
460000.0,3,1.75,1370,8467,1.0,4,970,400,98052
370000.0,3,2.75,1750,9166,1.0,4,1170,580,98155
431000.0,3,2.5,1710,12677,2.0,3,1710,0,98028
350000.0,4,2.5,2440,4000,2.0,3,2440,0,98038
242000.0,3,1.5,1640,8922,1.0,4,1640,0,98146
295000.0,3,1.5,1640,7222,2.0,4,1640,0,98108
614905.0,3,2.5,2410,7225,2.0,3,2410,0,98125
397000.0,4,2.5,1790,6590,2.0,3,1790,0,98059
184000.0,3,1.75,1490,10125,1.0,4,1490,0,98001
499100.0,3,1.5,1620,5108,1.0,3,1620,0,98115
390000.0,4,1.75,2180,7560,1.0,4,1560,620,98133
470000.0,3,2.75,2770,54707,1.5,3,2370,400,98155
415000.0,3,1.75,2410,8944,1.0,4,1860,550,98058
231000.0,4,2.0,1530,6375,2.0,3,1530,0,98058
470000.0,3,2.5,2280,6134,2.0,3,2280,0,98065
487000.0,4,2.25,2400,7000,1.0,4,1800,600,98034
255000.0,4,2.5,2163,5882,2.0,3,2163,0,98001
622000.0,3,2.5,1950,7481,2.0,3,1950,0,98027
292500.0,3,2.25,1390,6004,2.0,3,1390,0,98038
809000.0,4,1.5,1840,4337,2.0,4,1840,0,98112
305000.0,3,2.25,1646,9519,2.0,3,1646,0,98038
317000.0,3,1.5,1390,8300,1.0,4,1390,0,98019
310000.0,4,2.25,1780,8820,1.0,4,1480,300,98032
322500.0,3,2.0,1190,6445,1.0,3,1190,0,98056
320000.0,4,2.25,2000,10374,2.0,4,2000,0,98023
440000.0,3,2.5,1390,4997,2.0,3,1390,0,98065
535000.0,3,2.5,1720,4006,2.0,3,1720,0,98029
258900.0,3,2.25,1400,10436,1.0,4,1040,360,98058
563000.0,3,1.5,1730,9509,2.0,3,1270,460,98125
236775.0,3,2.5,1830,8372,2.0,3,1830,0,98023
621000.0,4,2.75,1950,6930,1.0,4,1250,700,98008
527900.0,3,2.5,2490,5928,2.0,3,2490,0,98065
395000.0,4,2.25,1780,10748,2.0,4,1780,0,98072
300000.0,4,2.5,2500,4750,2.0,3,2500,0,98042
320000.0,3,1.75,1480,7225,1.0,4,1480,0,98056
625000.0,3,2.25,2570,47480,1.0,3,2570,0,98053
363000.0,4,2.5,2180,9281,2.0,3,2180,0,98042
379900.0,4,1.75,1500,11600,1.0,4,1000,500,98028
548000.0,4,2.5,2440,11005,2.0,3,2440,0,98056
390000.0,3,2.25,1640,2875,2.0,3,1240,400,98118
449000.0,4,2.25,2230,8440,2.0,4,2230,0,98011
395000.0,4,2.0,1980,15354,1.0,3,1980,0,98053
300000.0,3,2.0,1470,16500,1.0,3,1470,0,98042
345000.0,3,1.75,1520,7439,1.0,4,1520,0,98055
825000.0,3,1.75,1930,8442,1.0,4,1930,0,98004
410000.0,4,2.0,1580,9581,1.0,3,1580,0,98033
270000.0,3,1.75,1390,9000,1.0,4,1390,0,98045
475000.0,3,1.75,1330,14560,1.0,3,1330,0,98052
445800.0,3,2.0,1320,6500,1.0,3,1320,0,98125
430000.0,3,2.5,1690,1310,2.0,3,1140,550,98136
296000.0,3,2.5,1560,5845,2.0,3,1560,0,98038
288250.0,3,1.75,2110,15400,1.0,3,1380,730,98178
224500.0,3,1.75,1300,7735,1.0,4,1300,0,98022
645000.0,3,2.0,2130,4000,2.0,3,2130,0,98115
250000.0,3,1.75,1360,16000,1.0,3,1360,0,98155
738500.0,3,2.5,2300,6009,1.0,3,2300,0,98053
385000.0,3,1.75,1230,7500,1.0,3,1230,0,98034
640000.0,4,2.5,2260,5172,2.0,3,2260,0,98052
500000.0,3,2.25,1730,13040,1.0,4,1290,440,98052
435000.0,3,1.75,1500,8173,1.0,3,1500,0,98034
365000.0,3,2.25,1960,1985,2.0,3,1750,210,98118
285000.0,3,1.5,1400,7582,1.0,3,1400,0,98148
220000.0,3,1.5,1600,10548,1.0,4,1600,0,98001
620000.0,3,2.5,2440,10363,2.0,3,2440,0,98029
545000.0,4,2.25,2030,11585,1.0,4,1590,440,98052
299900.0,3,1.75,1730,9893,1.0,4,1730,0,98042
639500.0,3,1.75,2010,8072,1.0,4,2010,0,98052
345000.0,4,1.5,1540,7168,1.0,3,1160,380,98055
698000.0,3,2.75,2640,11957,1.5,3,2260,380,98052
566000.0,4,2.25,2170,7737,2.0,3,2170,0,98074
449950.0,3,2.5,1530,3840,2.0,3,1530,0,98029
415000.0,4,2.0,1960,10559,2.0,4,1960,0,98133
320000.0,4,2.25,2190,9020,2.0,3,2190,0,98032
295000.0,3,2.5,1690,4102,2.0,3,1690,0,98038
299900.0,3,1.75,1470,27000,1.0,3,1470,0,98198
394000.0,3,2.5,2550,5349,2.0,3,2550,0,98038
775000.0,3,2.0,2010,7017,2.0,3,2010,0,98115
760000.0,4,2.25,2040,8315,1.0,4,1480,560,98177
620000.0,4,2.5,2130,9139,2.0,3,2130,0,98029
815000.0,3,2.5,2415,2186,2.0,3,2415,0,98033
245000.0,3,1.75,1670,24650,1.0,4,1670,0,98022
645000.0,3,2.75,1850,16960,1.0,4,1850,0,98177
402000.0,3,2.5,1970,12205,2.0,4,1970,0,98011
535500.0,3,2.5,2050,4976,2.0,3,2050,0,98029
305000.0,4,2.5,2230,6487,2.0,3,2230,0,98092
713250.0,3,2.0,2050,9000,1.0,4,2050,0,98040
345000.0,3,2.0,1610,15005,1.0,4,1610,0,98014
460000.0,3,1.5,1870,15685,1.0,3,1470,400,98133
224950.0,3,1.5,1630,9282,1.0,4,1630,0,98022
721000.0,4,2.75,2690,5400,2.0,3,2210,480,98117
658000.0,3,1.5,1660,3190,1.5,3,1660,0,98109
860000.0,3,2.0,1880,8494,1.0,4,1200,680,98004
270000.0,3,1.5,1230,7500,1.0,3,1230,0,98198
639000.0,4,2.5,1990,8034,2.0,4,1990,0,98029
585000.0,3,2.5,1700,1156,2.0,3,1320,380,98119
245000.0,4,1.75,2020,8800,1.0,4,2020,0,98023
225000.0,3,2.25,2510,12013,2.0,3,2510,0,98003
358000.0,3,2.25,2510,12013,2.0,3,2510,0,98003
325000.0,4,2.5,2230,8500,2.0,3,2230,0,98022
615000.0,4,2.5,2150,9070,2.0,4,2150,0,98052
321000.0,3,2.5,2020,4183,2.0,3,2020,0,98038
459000.0,4,1.5,2020,9583,2.0,4,2020,0,98034
435000.0,3,2.5,1730,4065,2.0,3,1730,0,98029
222000.0,3,1.75,1370,8280,1.0,4,1370,0,98031
266000.0,3,2.25,1550,6022,2.0,3,1550,0,98003
280000.0,3,1.75,1740,8625,1.0,4,1240,500,98023
685900.0,3,2.5,2290,9142,1.0,3,2290,0,98117
685000.0,4,2.5,2650,25248,1.0,3,2330,320,98177
597000.0,4,2.0,2120,4000,1.5,4,1720,400,98117
469000.0,3,2.0,1300,22605,1.0,3,1300,0,98056
375000.0,4,2.0,2270,18450,1.0,3,2270,0,98001
342450.0,3,1.5,1280,5525,1.0,3,1280,0,98133
315000.0,4,2.5,1950,3225,2.0,3,1950,0,98178
613200.0,3,2.75,2050,3320,1.5,4,1580,470,98105
475000.0,3,2.5,2480,6031,2.0,3,2480,0,98155
570000.0,3,2.25,2010,6000,1.0,3,1330,680,98052
653450.0,3,2.5,2070,49658,1.0,4,1540,530,98075
231200.0,3,2.0,1400,8821,1.0,3,1400,0,98022
680000.0,4,2.75,2500,4950,2.0,3,2500,0,98053
267500.0,3,1.5,1390,2153,2.0,3,1390,0,98118
435000.0,3,1.75,1310,8065,1.0,4,1310,0,98117
299995.0,3,2.5,1970,7500,2.0,3,1970,0,98092
625000.0,3,2.0,2168,12616,2.0,4,2168,0,98146
713500.0,3,2.0,1720,4200,2.0,3,1720,0,98112
425000.0,3,2.0,1500,8086,1.0,3,1060,440,98027
185000.0,3,1.5,1370,8470,1.0,4,1370,0,98092
222000.0,3,1.5,1310,9273,1.0,4,1310,0,98042
369000.0,3,1.75,1300,3844,1.0,3,1300,0,98133
380000.0,3,2.0,2010,16736,2.0,4,2010,0,98133
463000.0,3,2.0,1590,5009,2.0,4,1590,0,98125
225000.0,3,1.75,1580,14400,1.0,4,1580,0,98001
371000.0,3,1.75,1970,9512,1.0,3,1970,0,98058
625000.0,3,2.5,2330,3141,2.0,3,2330,0,98116
329000.0,3,1.75,1230,10725,1.0,3,1230,0,98045
634000.0,3,1.75,2570,13000,2.0,4,2570,0,98177
435000.0,4,2.25,1780,2684,2.0,3,1780,0,98072
320000.0,4,2.5,2110,6295,2.0,3,2110,0,98030
310000.0,3,2.5,1590,3359,2.0,3,1590,0,98019
443750.0,3,2.25,1460,968,2.0,3,1140,320,98199
795000.0,4,2.25,2070,13084,1.0,4,1700,370,98040
279950.0,3,1.75,1660,8303,1.0,3,1380,280,98058
659000.0,4,2.0,2350,9329,2.0,3,2350,0,98005
250000.0,3,1.75,1590,7560,1.0,3,1130,460,98031
545000.0,3,2.25,2290,14585,2.0,3,2290,0,98075
360000.0,3,2.5,2150,14092,2.0,3,2150,0,98058
760000.0,3,1.5,1170,7645,1.0,4,1170,0,98004
750000.0,3,2.5,2560,9182,2.0,3,2560,0,98027
251000.0,3,2.0,1650,7930,1.0,4,1650,0,98038
340000.0,4,2.5,1954,4805,2.0,3,1954,0,98055
299950.0,4,2.25,1810,7601,1.0,3,1080,730,98023
440000.0,4,2.5,2410,7517,2.0,3,2410,0,98058
293000.0,3,2.5,1690,17383,2.0,3,1690,0,98038
203000.0,3,1.75,1190,6000,1.0,3,1190,0,98178
305000.0,3,1.75,1460,7862,1.0,3,1460,0,98155
495000.0,4,1.75,1600,6380,1.0,3,1130,470,98125
420000.0,3,1.75,1770,6000,1.0,3,1130,640,98125
466000.0,3,1.75,1680,9460,1.0,4,1680,0,98006
432100.0,3,2.25,1790,2240,2.0,4,1790,0,98052
500000.0,3,2.5,2410,34848,1.5,3,2410,0,98006
285000.0,4,2.5,1800,9229,2.0,3,1800,0,98022
365000.0,4,1.5,1820,12327,1.0,4,1380,440,98006
622000.0,3,1.5,1650,3150,1.5,4,1650,0,98122
305000.0,4,2.5,2320,4683,2.0,3,2320,0,98042
259900.0,4,2.75,1560,8820,1.0,3,1060,500,98001
420000.0,3,2.0,2330,6346,1.5,3,1600,730,98146
249950.0,3,1.5,1450,6875,1.0,4,1450,0,98198
425000.0,3,1.5,1970,13709,1.0,4,1680,290,98155
335000.0,3,2.5,1940,4927,2.0,3,1940,0,98058
476500.0,4,1.75,1670,10200,1.0,3,1390,280,98118
368500.0,4,2.75,2500,26400,1.0,3,1780,720,98031
278100.0,4,1.75,2120,8520,1.0,3,1600,520,98023
349950.0,4,2.5,2000,5006,2.0,3,2000,0,98058
425000.0,4,2.5,2400,6053,2.0,3,2400,0,98038
435000.0,4,2.75,2110,8751,1.0,3,1510,600,98011
323000.0,4,1.75,1440,8114,1.0,4,1440,0,98155
333000.0,4,2.5,2100,7208,2.0,3,2100,0,98058
850000.0,3,2.25,2220,3707,2.0,4,1620,600,98122
408000.0,3,1.75,1970,7100,1.0,3,1590,380,98072
499000.0,4,2.25,2440,5000,2.0,3,2440,0,98065
760000.0,4,2.25,2590,12600,2.0,3,2590,0,98006
505000.0,3,1.75,1240,4550,1.5,4,1240,0,98116
287500.0,3,2.25,2030,8690,1.0,4,1360,670,98023
450000.0,3,1.5,1390,10530,1.0,3,1390,0,98033
350000.0,3,1.75,1490,10344,1.0,3,1490,0,98155
270000.0,3,2.0,1510,10215,1.0,4,1510,0,98022
284000.0,3,1.75,1320,35100,1.0,3,1320,0,98092
308000.0,4,2.5,2330,4606,2.0,3,2330,0,98031
540000.0,4,2.5,2050,34222,2.0,4,2050,0,98077
380000.0,4,1.5,1680,11123,1.0,3,1130,550,98177
280400.0,4,1.75,1730,7210,1.0,4,1010,720,98003
787000.0,3,1.75,1330,7500,1.0,3,1330,0,98004
537000.0,4,2.5,1990,2660,2.0,3,1990,0,98034
238000.0,4,2.5,1690,7260,1.0,3,1080,610,98023
525000.0,3,2.5,2190,34528,2.0,3,2190,0,98027
480000.0,3,1.5,1200,3060,1.0,4,1060,140,98115
279000.0,3,2.5,1630,7950,1.0,3,1320,310,98042
336500.0,4,1.75,1760,7268,1.0,4,1080,680,98058
330000.0,3,2.25,1440,5150,2.0,3,1440,0,98106
435000.0,3,2.5,1730,46638,2.0,3,1730,0,98045
299950.0,3,2.5,1570,2577,2.0,3,1570,0,98019
386000.0,3,1.5,1550,8000,1.0,3,1330,220,98118
220000.0,3,1.75,1720,7587,1.0,4,1140,580,98092
255000.0,4,2.75,1760,9222,1.0,3,1140,620,98023
447000.0,3,1.75,1400,6750,1.0,3,1040,360,98034
287000.0,3,2.5,1820,8722,1.5,3,1820,0,98022
415000.0,3,2.75,1770,3172,2.0,3,1770,0,98065
567000.0,3,2.25,1800,6875,1.0,4,1230,570,98052
183000.0,3,1.75,1330,9200,1.0,4,1330,0,98092
335000.0,3,1.75,1900,36769,1.0,3,1900,0,98092
650000.0,3,2.25,1790,9927,1.0,4,1240,550,98075
328000.0,4,2.5,2370,6500,2.0,3,2370,0,98092
441000.0,3,2.5,1890,11036,1.0,3,1460,430,98133
370000.0,3,1.75,1480,7725,1.5,4,1480,0,98059
470500.0,4,2.25,2070,14000,1.0,3,1720,350,98028
268000.0,3,2.5,1650,6684,2.0,3,1650,0,98031
275000.0,4,2.0,2220,8229,1.5,4,2220,0,98030
260000.0,4,2.5,2000,37045,2.0,3,2000,0,98042
258000.0,3,2.5,1730,6930,2.0,3,1730,0,98003
525000.0,3,2.0,1540,7800,1.0,3,1540,0,98125
300000.0,3,2.5,1870,3439,2.0,3,1870,0,98042
330000.0,3,1.5,1690,10250,1.0,4,1690,0,98166
269950.0,3,2.25,1610,7187,2.0,3,1610,0,98042
621500.0,3,1.75,2570,39634,2.0,3,2570,0,98075
203000.0,3,1.5,1370,7500,1.0,3,1080,290,98198
733500.0,3,1.5,2120,4370,1.5,3,2120,0,98122
364950.0,3,2.25,2520,6170,2.0,3,1850,670,98038
490000.0,3,1.75,1560,9247,1.0,3,1160,400,98033
380600.0,3,2.5,1920,12244,2.0,3,1920,0,98019
613000.0,3,2.5,1350,3068,2.0,3,1350,0,98122
480000.0,3,2.0,1470,10052,1.0,4,1470,0,98125
437000.0,4,2.5,1890,8505,1.0,3,1290,600,98052
621000.0,4,2.5,2030,9905,1.0,4,2030,0,98006
810000.0,4,1.75,1760,4080,1.5,4,1760,0,98103
415000.0,3,2.25,1950,8868,1.0,3,1350,600,98155
500000.0,3,1.5,1330,1265,2.0,3,1140,190,98116
508000.0,3,1.75,1800,8462,1.0,3,1440,360,98052
228950.0,3,1.75,1200,9085,1.0,4,1200,0,98023
370000.0,3,1.75,1290,10117,1.0,3,1290,0,98072
660000.0,3,1.75,1750,5200,1.0,4,1750,0,98117
787888.0,4,2.25,2580,21115,2.0,4,2580,0,98040
375000.0,3,2.0,1640,9750,1.0,3,1640,0,98028
224000.0,3,1.5,1440,8370,1.0,3,1440,0,98118
285000.0,3,1.75,1720,13104,1.0,4,1720,0,98168
190000.0,3,1.75,1270,7875,1.0,4,1270,0,98030
374000.0,3,1.75,1510,18439,1.0,3,1510,0,98027
400000.0,3,2.5,2090,32718,2.0,3,1550,540,98070
453000.0,3,1.75,1430,20193,1.0,3,1430,0,98006
359950.0,3,2.75,2540,8604,2.0,3,2540,0,98092
616000.0,4,2.5,2490,12929,2.0,3,2490,0,98074
419900.0,3,2.5,1630,1755,2.0,3,1320,310,98033
315000.0,3,2.0,1900,9513,1.0,3,1900,0,98023
220000.0,3,2.5,1980,11900,2.0,3,1980,0,98092
575000.0,3,1.75,1580,11750,1.0,4,1180,400,98118
285000.0,3,2.5,2090,10834,1.0,4,1360,730,98003
325000.0,3,2.5,1870,3480,2.0,3,1870,0,98056
256500.0,3,2.0,1320,8568,1.0,3,1320,0,98042
549000.0,3,2.5,2250,9235,2.0,3,2250,0,98052
317000.0,4,2.5,2160,8049,2.0,3,2160,0,98001
450000.0,3,1.75,1400,13775,1.0,3,1400,0,98028
515000.0,3,2.5,2010,7200,2.0,3,2010,0,98028
314950.0,3,2.5,1690,4533,2.0,3,1690,0,98038
375000.0,3,2.0,1410,10078,1.0,4,1410,0,98072
500000.0,3,1.75,1640,47044,1.0,3,1640,0,98014
525000.0,3,2.25,1290,1182,2.0,3,1000,290,98102
250000.0,4,1.5,1220,4900,1.0,3,1220,0,98118
262000.0,3,2.5,1700,6200,2.0,3,1700,0,98092
500000.0,3,1.75,1220,7370,1.0,4,1220,0,98008
675000.0,3,2.25,2610,9002,2.0,3,2610,0,98052
875000.0,3,2.0,2350,6000,1.5,4,1990,360,98102
325000.0,3,1.5,1310,2998,2.0,3,1310,0,98144
775000.0,3,2.5,2480,5007,2.0,3,1960,520,98117
585000.0,4,2.5,2430,6766,2.0,3,2430,0,98177
587000.0,3,2.5,2150,5193,2.0,3,2150,0,98033
570000.0,3,1.5,1300,7287,1.0,4,1300,0,98033
262500.0,3,1.5,1610,10291,1.0,4,1610,0,98022
536000.0,3,2.5,1990,7397,2.0,3,1990,0,98072
435000.0,3,2.25,1890,7200,1.0,4,1230,660,98125
300000.0,3,2.25,1760,5421,2.0,3,1760,0,98038
771000.0,3,2.25,1780,6120,1.5,4,1390,390,98122
335000.0,4,2.5,2610,4781,2.0,3,2610,0,98001
390000.0,3,1.75,1850,15170,1.0,3,1850,0,98045
288000.0,3,2.25,1560,9706,1.0,4,1560,0,98002
403000.0,3,1.75,1270,10790,1.0,3,1270,0,98033
575000.0,3,2.0,1730,9030,1.0,4,1730,0,98007
330000.0,3,1.75,1250,8100,1.0,3,1250,0,98146
456000.0,3,2.5,1820,2935,2.0,3,1820,0,98074
460000.0,3,1.75,1400,12155,1.0,4,1400,0,98075
475000.0,3,2.25,1820,8008,1.0,3,1240,580,98052
507000.0,4,2.0,1360,2746,1.5,3,1360,0,98107
359500.0,4,2.75,2140,10316,2.0,3,2140,0,98001
248000.0,3,1.75,1330,9831,1.0,3,1330,0,98001
510000.0,3,1.5,1730,6240,1.0,3,1000,730,98136
418000.0,4,1.5,1550,9176,1.0,3,1000,550,98008
515000.0,3,1.75,1580,9147,1.0,4,1210,370,98008
445000.0,3,1.75,1410,5100,1.0,4,1110,300,98125
212000.0,3,1.5,1690,9600,1.0,3,1210,480,98038
520000.0,3,1.75,2310,36665,1.0,3,1580,730,98155
320000.0,4,2.75,1640,3000,1.0,3,1000,640,98118
245000.0,3,2.5,1600,2788,2.0,4,1600,0,98031
640000.0,3,2.0,1380,4800,1.0,3,1380,0,98199
307999.0,4,2.75,2420,8438,2.0,3,2420,0,98022
235000.0,3,1.75,1420,7920,1.0,4,1420,0,98092
525000.0,3,2.0,1640,15258,1.0,3,1640,0,98074
377500.0,3,2.0,1370,7200,1.0,3,1130,240,98125
587450.0,3,2.25,2190,8775,1.5,4,2190,0,98125
245000.0,3,2.25,1530,12000,1.0,3,1070,460,98023
200000.0,3,2.0,1290,5757,1.0,3,1290,0,98092
607000.0,3,2.5,2470,9226,2.0,3,2470,0,98072
525000.0,3,2.5,2030,6970,2.0,4,2030,0,98029
440000.0,3,1.75,2000,9900,1.0,4,1480,520,98166
366000.0,4,2.75,2170,9743,2.0,3,2170,0,98038
299000.0,3,1.5,1190,9135,1.0,4,1190,0,98056
460000.0,3,1.75,1290,8580,1.0,4,1290,0,98033
224000.0,3,1.5,1480,10588,1.0,3,1480,0,98002
330000.0,3,2.5,2040,14071,2.0,3,2040,0,98019
649950.0,3,2.5,2150,15304,2.0,4,2150,0,98006
515000.0,3,2.75,1710,9448,1.0,3,1010,700,98105
452000.0,3,2.5,1530,5032,2.0,3,1530,0,98103
236000.0,4,2.5,1630,3060,2.0,3,1630,0,98146
340000.0,4,2.5,2170,19785,2.0,3,2170,0,98031
236000.0,3,1.75,1330,6301,1.0,3,1330,0,98002
330000.0,4,1.75,1720,8300,1.0,4,1720,0,98055
332000.0,3,2.5,1530,9406,1.0,3,1270,260,98059
453000.0,3,1.75,1600,7232,1.0,3,1600,0,98008
330000.0,3,1.75,1430,8865,1.0,3,1430,0,98125
285000.0,4,2.5,1996,4547,2.0,3,1996,0,98042
336500.0,3,2.0,1830,12891,1.0,3,1830,0,98031
225000.0,3,1.75,1370,10866,1.0,4,1370,0,98052
270000.0,3,1.75,1370,10866,1.0,4,1370,0,98052
400000.0,3,2.25,1740,11040,2.0,3,1740,0,98028
555000.0,3,2.5,2480,8676,2.0,4,2480,0,98056
230000.0,3,2.5,1920,9180,2.0,3,1920,0,98055
355000.0,4,1.75,2160,8000,1.0,4,1660,500,98023
635000.0,4,2.5,2570,27972,2.0,3,2570,0,98053
265000.0,3,1.5,1780,10196,1.0,4,1270,510,98001
250000.0,4,1.75,1910,8250,1.0,4,1910,0,98008
453000.0,3,2.0,1430,9583,1.0,4,1430,0,98034
385000.0,3,1.5,1490,9630,1.0,4,1490,0,98028
215000.0,3,1.75,1210,8075,1.0,4,1210,0,98001
415000.0,3,2.5,1980,4274,2.0,3,1980,0,98028
880000.0,3,2.0,2130,35169,1.0,4,2130,0,98072
332000.0,3,2.0,1510,7884,1.0,3,1510,0,98166
445000.0,3,1.75,1750,7200,1.0,3,1750,0,98008
752000.0,4,1.5,1650,2970,1.5,3,1650,0,98102
330000.0,4,2.5,2310,6320,2.0,3,2310,0,98092
409000.0,3,1.75,1440,9065,1.0,4,1440,0,98133
570000.0,4,2.5,2430,44001,1.0,3,2430,0,98019
442500.0,4,2.5,2400,7092,2.0,3,2400,0,98133
506400.0,3,2.5,2100,9040,1.0,3,1700,400,98056
324000.0,3,2.25,1550,4411,2.0,3,1550,0,98019
270000.0,3,2.5,1540,7739,2.0,4,1540,0,98030
726500.0,4,2.5,2180,3893,2.0,3,2180,0,98117
316000.0,3,2.25,2130,8721,1.0,3,1570,560,98031
498000.0,4,2.5,2300,22445,2.0,4,2300,0,98014
510000.0,4,2.5,2610,8031,2.0,3,2610,0,98155
520000.0,3,2.5,2460,54885,2.0,4,2460,0,98059
285000.0,3,2.5,1870,4060,2.0,3,1870,0,98042
570000.0,4,2.5,2590,8483,2.0,3,2590,0,98011
459950.0,4,2.0,2760,21465,1.0,4,2120,640,98042
290000.0,3,1.75,1520,15090,1.0,4,1520,0,98038
279000.0,4,2.0,1980,10051,1.0,3,1980,0,98092
510000.0,3,1.75,1480,7040,1.0,3,1480,0,98033
559000.0,3,1.75,1700,6500,1.0,3,1700,0,98115
575700.0,3,1.75,1730,6130,1.0,3,1480,250,98115
381000.0,3,1.5,1460,11407,1.0,3,1460,0,98155
425000.0,3,2.25,1400,6970,2.0,3,1400,0,98006
190000.0,3,1.75,1520,9600,1.0,4,1520,0,98059
314950.0,3,1.75,1520,9600,1.0,4,1520,0,98059
565000.0,4,2.25,2110,10698,2.0,4,2110,0,98027
430000.0,3,1.75,1610,7900,1.0,4,1310,300,98177
225000.0,3,1.75,1460,8372,1.0,4,1460,0,98042
329950.0,4,2.5,2120,4558,2.0,3,2120,0,98038
692000.0,4,2.5,2350,9779,1.0,3,2350,0,98074
510000.0,3,1.75,1920,43560,1.0,4,1340,580,98074
244900.0,3,1.5,1360,9980,1.0,4,1360,0,98031
286000.0,3,1.75,1770,9000,1.0,3,1090,680,98168
318000.0,3,1.75,1570,12506,1.0,4,1570,0,98003
588000.0,3,1.5,1780,4200,1.5,4,1780,0,98103
402000.0,3,2.0,1540,1827,2.0,3,1540,0,98029
445000.0,3,1.75,1890,32340,1.5,3,1890,0,98070
195000.0,3,1.75,1570,8459,1.0,3,1570,0,98022
450000.0,3,1.5,1520,7903,1.0,4,1000,520,98006
380000.0,3,1.75,1300,12378,1.0,4,1300,0,98045
270000.0,3,1.5,1610,8375,2.0,3,1610,0,98155
454280.0,3,2.5,1470,1741,2.0,3,1170,300,98029
390000.0,3,2.5,1410,26375,1.0,3,1410,0,98077
275000.0,3,1.75,1840,14005,1.0,3,1840,0,98023
300000.0,4,2.5,2450,8932,2.0,3,2450,0,98023
404000.0,3,2.5,2370,4324,2.0,3,2370,0,98038
410000.0,4,2.5,2560,4020,2.0,3,2560,0,98038
225000.0,3,1.5,1240,5506,1.0,4,1240,0,98118
700000.0,4,2.5,2590,4498,2.0,3,2590,0,98052
330000.0,3,2.5,2060,25046,1.0,4,1600,460,98022
649990.0,4,2.25,2130,11900,2.0,3,2130,0,98074
348000.0,3,2.5,1730,4004,2.0,3,1730,0,98148
373000.0,3,2.5,1670,3565,2.0,3,1670,0,98072
237500.0,3,1.75,1480,7830,1.0,3,1480,0,98022
650000.0,3,2.5,2380,3332,2.0,3,2380,0,98034
625000.0,3,2.0,1730,12219,1.0,4,1730,0,98004
587100.0,3,2.25,1670,6414,1.0,4,1670,0,98117
380000.0,4,2.5,2150,37647,2.0,3,2150,0,98042
305100.0,3,2.0,1590,35988,1.0,4,1590,0,98058
810000.0,3,2.5,2610,8481,2.0,3,2610,0,98006
500000.0,3,2.25,1440,15661,1.0,3,1180,260,98074
272000.0,4,1.75,1390,10660,1.0,4,1030,360,98198
280000.0,3,2.25,2140,7200,2.0,4,2140,0,98031
445000.0,3,2.75,2180,3703,2.0,3,2180,0,98011
358000.0,3,1.5,2450,12497,1.0,4,2450,0,98065
540000.0,3,1.75,2280,16671,1.5,4,1760,520,98034
270500.0,3,1.5,1952,8613,1.0,4,1652,300,98032
540000.0,4,2.5,2600,9935,2.0,3,2600,0,98059
380000.0,4,2.5,2300,7707,2.0,3,2300,0,98038
270000.0,3,2.25,1750,8400,1.0,3,1350,400,98188
659000.0,3,1.5,1540,5040,2.0,3,1540,0,98122
285000.0,4,2.5,2434,4400,2.0,3,2434,0,98001
750000.0,3,1.75,1700,8400,1.0,3,1460,240,98199
800000.0,4,2.25,2510,9963,1.0,4,2200,310,98005
353750.0,4,2.0,1710,7490,2.0,3,1320,390,98166
465000.0,4,2.0,1470,10291,1.0,4,1470,0,98008
568000.0,3,2.0,2350,5080,1.5,3,1780,570,98118
571000.0,3,2.5,2600,7465,2.0,3,2600,0,98011
275000.0,4,1.5,1930,15531,2.0,3,1930,0,98003
460000.0,3,1.75,1970,9135,1.0,4,1370,600,98011
500000.0,4,2.0,2100,12620,1.0,4,2100,0,98034
249000.0,4,2.25,1830,6136,2.0,3,1830,0,98030
235000.0,3,2.0,1530,8700,1.0,4,1530,0,98055
410000.0,4,2.0,1490,13736,1.0,4,1490,0,98125
298000.0,4,2.5,2420,3825,2.0,3,2420,0,98042
485000.0,4,2.25,1900,7200,1.0,3,1370,530,98146
400000.0,3,1.75,1330,9143,1.0,3,1330,0,98006
580000.0,3,2.5,2150,4604,2.0,3,2150,0,98075
650000.0,3,2.5,2430,12997,2.0,3,2430,0,98011
601000.0,3,2.5,1740,1251,2.0,3,1180,560,98199
291000.0,3,2.25,1480,7200,1.0,3,1190,290,98023
560000.0,3,2.5,2280,12498,2.0,4,2280,0,98029
200000.0,4,1.5,1780,8000,2.0,4,1080,700,98010
281000.0,3,2.5,1760,7601,2.0,3,1760,0,98003
270000.0,3,2.25,2100,14027,2.0,3,2100,0,98042
350000.0,3,1.75,1260,1111,2.0,3,1260,0,98029
289900.0,3,1.75,1899,11325,2.0,3,1899,0,98198
269000.0,3,2.5,1730,6653,1.0,4,1360,370,98042
280000.0,3,2.25,1860,9210,2.0,3,1860,0,98038
287000.0,3,1.75,1940,9000,1.0,3,1290,650,98055
405000.0,3,1.75,1520,7252,1.0,3,1140,380,98072
440000.0,3,2.0,1800,10950,1.0,4,1800,0,98006
345000.0,4,2.5,2331,3826,2.0,3,2331,0,98058
350000.0,4,1.75,1820,6930,1.0,4,1320,500,98178
259950.0,4,2.0,1610,6650,1.0,3,1610,0,98023
460000.0,3,1.75,2560,8400,1.0,3,1970,590,98011
214000.0,3,2.5,1600,2231,2.0,3,1600,0,98001
275000.0,3,2.5,2497,4400,2.0,3,2497,0,98001
305000.0,3,1.5,1800,12196,1.0,4,1800,0,98023
348000.0,3,2.5,1670,5090,2.0,3,1670,0,98056
815000.0,3,2.5,2590,21494,2.0,4,2590,0,98074
386000.0,3,2.0,1330,8100,1.0,4,1330,0,98034
273000.0,3,2.25,2160,7964,2.0,3,2160,0,98042
284000.0,4,2.5,1830,6360,2.0,3,1830,0,98031
315000.0,3,2.5,1790,6452,2.0,3,1790,0,98038
290000.0,4,2.0,1630,7618,1.5,3,1630,0,98198
410000.0,3,2.0,1650,9641,1.5,3,1650,0,98034
230000.0,3,2.25,1490,8722,2.0,3,1490,0,98030
404763.0,3,2.5,1690,1609,2.0,3,1150,540,98029
245000.0,3,2.5,1720,3407,2.0,3,1720,0,98031
626100.0,4,2.5,2280,7219,2.0,4,2280,0,98029
522000.0,4,2.25,1800,8623,1.0,4,1360,440,98033
684000.0,4,2.5,2500,8434,2.0,4,2500,0,98052
368000.0,3,1.75,1710,10800,1.0,4,1710,0,98028
720000.0,3,2.0,1590,5200,1.0,3,1320,270,98103
525000.0,4,2.25,1890,8549,1.0,3,1890,0,98008
405000.0,3,2.0,1740,18000,1.0,3,1230,510,98028
394999.0,3,1.5,1730,7800,1.0,3,1330,400,98133
340000.0,3,2.5,2480,6112,2.0,3,2480,0,98058
482500.0,3,2.25,1450,1445,2.0,3,980,470,98122
398000.0,3,1.75,1830,27468,1.0,3,1830,0,98028
225000.0,3,1.5,1220,8345,1.5,3,1220,0,98178
454000.0,3,2.5,1590,4094,2.0,3,1590,0,98122
555000.0,3,1.75,1270,9170,1.0,3,1270,0,98052
590000.0,3,2.5,2210,8622,2.0,3,2210,0,98029
390000.0,3,1.75,1430,9857,1.0,4,1140,290,98045
790000.0,3,2.5,2390,15084,2.0,3,2390,0,98010
680000.0,3,1.75,1620,5500,1.0,3,1110,510,98112
375000.0,4,2.5,1870,7471,2.0,3,1870,0,98055
463000.0,3,2.5,2190,17108,2.0,3,2190,0,98019
350000.0,3,1.75,1320,10500,1.0,3,1320,0,98034
355000.0,4,1.75,2040,15000,1.0,4,1360,680,98092
229000.0,3,2.0,1540,6000,1.0,4,1540,0,98155
430000.0,3,2.0,1540,6000,1.0,4,1540,0,98155
510000.0,3,1.75,1370,6700,1.0,3,1370,0,98117
440000.0,3,2.25,1760,1800,2.0,3,1330,430,98199
349950.0,3,2.5,2240,7565,2.0,3,2240,0,98003
225000.0,3,1.75,1550,9060,2.0,3,1550,0,98146
770000.0,3,1.75,1720,5000,1.0,3,1720,0,98122
340000.0,3,1.75,1740,10800,1.0,3,1740,0,98133
667000.0,3,2.75,2216,31215,1.0,3,2216,0,98092
329800.0,4,2.5,2080,7047,2.0,3,2080,0,98092
450000.0,4,2.5,1900,9240,1.0,3,1900,0,98007
625000.0,4,2.0,1410,4480,1.5,3,1410,0,98109
395000.0,3,1.75,1400,8640,1.0,3,1400,0,98011
427500.0,3,1.5,1900,43186,1.5,4,1300,600,98038
260000.0,3,2.0,1920,8075,1.0,4,1510,410,98023
625000.0,3,1.5,1990,5978,1.5,4,1990,0,98198
413565.0,3,2.5,1690,1613,2.0,3,1150,540,98029
679000.0,4,1.75,2260,41236,1.0,4,1690,570,98029
585888.0,3,2.0,1490,7431,1.0,4,1490,0,98052
405000.0,4,2.5,2220,4652,2.0,3,2220,0,98059
220000.0,3,2.25,1400,7205,1.0,3,1140,260,98030
883000.0,4,2.5,2800,6874,2.0,3,2170,630,98112
320000.0,3,2.5,1610,1356,2.0,3,1240,370,98106
425000.0,3,1.75,1510,44000,1.0,3,1240,270,98045
204700.0,4,2.0,1670,9987,1.0,3,1670,0,98001
314000.0,3,2.75,1900,8200,2.0,4,1900,0,98031
535000.0,3,2.5,2390,6263,2.0,3,2390,0,98028
380000.0,4,2.5,2540,6365,2.0,3,1870,670,98055
429000.0,3,2.0,1700,52826,1.0,3,1700,0,98058
799000.0,4,1.5,1810,6583,1.0,3,1500,310,98133
250000.0,3,1.75,1200,24805,1.0,3,1200,0,98031
562000.0,3,1.5,1830,8000,1.0,4,1830,0,98008
284850.0,3,1.5,1590,8256,1.0,3,1090,500,98003
570000.0,4,2.5,2590,7910,2.0,3,2590,0,98028
304000.0,3,1.75,1720,6000,1.0,3,1000,720,98178
560000.0,4,2.5,1790,9787,1.0,4,1240,550,98056
557510.0,4,2.0,1580,4800,1.5,3,1580,0,98136
534950.0,3,2.25,2130,12286,2.0,3,2130,0,98052
500000.0,3,1.75,1480,6120,1.5,3,1480,0,98115
319502.0,3,1.75,1610,38707,1.0,3,1610,0,98010
525000.0,4,2.75,2440,5080,2.0,3,1750,690,98126
295000.0,3,2.0,1760,6092,1.0,3,1760,0,98030
315000.0,3,2.25,2170,8480,1.0,3,2170,0,98148
338000.0,4,2.5,2370,10631,2.0,3,2370,0,98003
353000.0,4,2.5,2300,4249,2.0,3,2300,0,98038
235000.0,3,1.75,1400,6300,1.0,3,1400,0,98022
505000.0,4,2.25,2350,12540,2.0,3,2350,0,98177
304000.0,4,2.0,1310,8454,1.0,4,1310,0,98155
272000.0,4,2.25,1800,5555,2.0,3,1800,0,98038
305000.0,3,2.5,2100,6825,2.0,3,2100,0,98055
585000.0,4,2.0,2400,12753,1.0,4,2400,0,98033
570000.0,3,1.75,1930,36210,1.0,3,1930,0,98072
525000.0,4,1.5,1430,6380,1.5,4,1130,300,98115
240000.0,3,2.25,1500,15334,2.0,4,1500,0,98042
405000.0,3,1.75,1260,7373,1.0,4,1260,0,98034
272950.0,3,2.25,1570,9096,1.0,4,1180,390,98022
670000.0,3,1.75,1280,2147,1.5,4,1280,0,98102
465500.0,3,1.75,1890,7004,1.0,3,1290,600,98118
443500.0,3,2.5,2170,5866,2.0,3,2170,0,98065
470000.0,3,2.5,2150,8221,2.0,3,2150,0,98059
307150.0,3,1.5,1480,6752,1.0,4,1480,0,98056
289000.0,4,2.5,1961,3207,2.0,3,1961,0,98042
529000.0,3,1.75,1500,7367,1.0,3,1500,0,98033
585000.0,3,1.75,1480,4800,2.0,4,1140,340,98199
580000.0,3,2.25,2190,8188,2.0,3,1810,380,98052
379000.0,4,2.75,2410,5225,2.0,3,2410,0,98058
480000.0,4,2.25,2330,14190,1.0,3,1740,590,98034
650000.0,3,1.75,1940,10245,1.0,3,1940,0,98040
570000.0,4,1.75,1860,7700,1.0,4,1860,0,98008
660000.0,4,2.25,2010,15375,1.0,4,2010,0,98005
368000.0,3,2.5,2080,4307,2.0,3,2080,0,98065
650000.0,4,2.5,2500,6005,2.0,3,2500,0,98033
485000.0,3,2.0,2410,50654,1.5,3,2410,0,98070
425000.0,3,2.5,1340,10018,1.0,4,1340,0,98052
315000.0,4,2.75,1580,3770,1.0,3,1080,500,98019
500000.0,3,2.25,2210,7916,2.0,3,2210,0,98133
200000.0,4,2.0,1900,8160,1.0,3,1900,0,98022
265000.0,3,2.5,1640,7668,2.0,3,1640,0,98038
432500.0,3,1.75,1980,5100,1.0,3,1270,710,98103
490000.0,3,1.75,1510,8433,1.0,4,1220,290,98008
270000.0,3,2.5,1690,7165,2.0,4,1690,0,98038
327500.0,3,2.5,2090,12027,2.0,3,2090,0,98031
510000.0,3,1.75,1750,7020,2.0,3,1750,0,98010
439000.0,3,2.25,1480,7565,1.0,3,1220,260,98034
235000.0,3,1.75,1380,8362,1.0,3,1380,0,98003
370000.0,3,1.75,1620,37913,2.0,4,1620,0,98001
309000.0,3,2.5,1780,7859,2.0,3,1780,0,98038
323000.0,3,1.75,1830,12500,1.0,3,1200,630,98178
551000.0,4,1.5,1470,5100,1.5,3,1470,0,98117
218000.0,3,1.75,1850,7684,1.0,3,1320,530,98023
334950.0,4,2.5,2190,7000,2.0,3,2190,0,98042
605000.0,4,2.25,2510,31584,2.0,4,2510,0,98074
268500.0,4,1.75,1670,8000,1.0,4,1670,0,98023
440000.0,3,2.25,1880,7989,1.0,3,1280,600,98125
571500.0,4,2.75,2180,5799,2.0,4,2180,0,98029
182500.0,3,2.25,1830,4744,2.0,3,1830,0,98001
340000.0,3,1.75,2230,10403,1.0,3,1630,600,98198
465000.0,4,2.25,2550,7650,2.0,4,2550,0,98106
551870.0,3,2.5,2507,18400,2.0,3,2507,0,98001
295000.0,3,2.5,1920,7229,2.0,3,1920,0,98003
263500.0,4,1.75,2210,6375,1.0,3,1640,570,98003
325000.0,3,1.5,1590,7936,1.0,3,1590,0,98106
329950.0,4,1.75,1740,7208,1.5,3,1740,0,98058
490000.0,3,2.25,1470,2500,2.0,3,1080,390,98117
510000.0,4,2.5,1620,8125,2.0,4,1620,0,98074
550000.0,3,2.5,2360,4080,2.0,3,2360,0,98053
251200.0,4,1.5,1310,8250,1.0,3,1060,250,98148
215000.0,3,1.5,1610,5304,1.0,4,1610,0,98042
245000.0,3,2.0,1850,8208,1.0,4,1180,670,98023
259000.0,3,1.75,1270,4815,1.5,3,980,290,98108
349950.0,4,1.5,1420,6720,1.5,3,1420,0,98108
625000.0,3,2.5,1860,10027,2.0,3,1860,0,98033
415500.0,3,1.5,1240,12400,1.0,3,1240,0,98007
840000.0,3,2.5,2060,9715,2.0,3,2060,0,98115
285000.0,3,1.5,1380,12196,1.0,4,1380,0,98003
475000.0,4,2.25,1800,7200,1.0,3,1230,570,98177
685000.0,3,2.0,2210,5000,1.5,3,1710,500,98103
792000.0,3,1.5,1570,1050,2.0,3,1570,0,98109
262000.0,3,2.5,1680,10300,2.0,4,1680,0,98010
305000.0,3,2.5,1690,5175,2.0,3,1690,0,98038
270000.0,3,2.25,1760,8287,1.0,3,1160,600,98188
447450.0,3,2.25,1570,7200,2.0,3,1570,0,98034
375000.0,3,2.0,2240,5200,1.0,3,1630,610,98112
565000.0,4,2.0,1950,9940,1.0,4,1950,0,98008
246000.0,3,1.5,1630,10200,1.0,4,1300,330,98023
329922.0,3,1.75,1420,6289,1.0,3,1100,320,98155
385000.0,3,1.75,1890,9920,1.0,3,1230,660,98125
591500.0,4,2.5,1690,4080,1.5,4,1140,550,98117
275000.0,3,1.5,1350,7800,1.0,3,1350,0,98059
225000.0,3,2.5,1590,8449,2.0,3,1590,0,98030
375500.0,3,1.5,1530,7200,1.0,3,1530,0,98155
350000.0,4,2.5,2380,6124,2.0,3,2380,0,98030
309900.0,3,2.5,2020,26670,2.0,3,2020,0,98003
257000.0,3,2.25,1810,12000,2.0,3,1810,0,98003
300000.0,3,2.0,1260,2550,2.0,3,1260,0,98117
213400.0,4,2.5,1680,6655,2.0,3,1680,0,98030
499000.0,3,2.25,1780,3665,2.0,3,1780,0,98029
291500.0,4,2.5,1770,5000,2.0,3,1770,0,98038
350000.0,4,1.75,2250,13515,1.0,4,2150,100,98030
279000.0,3,2.5,1540,7280,1.0,3,1080,460,98003
215000.0,3,1.75,1770,29004,1.0,3,1770,0,98023
423500.0,3,2.25,1890,7498,1.0,3,1190,700,98125
505000.0,3,2.25,1460,7210,1.0,3,1460,0,98008
349170.0,4,1.75,1670,8856,1.0,3,1070,600,98178
287000.0,4,1.5,1300,10050,1.5,3,1300,0,98059
525000.0,4,1.5,1680,10500,2.0,3,1680,0,98033
405000.0,3,2.5,1960,6997,2.0,3,1960,0,98065
808000.0,3,1.75,2590,32380,1.0,3,2590,0,98177
367500.0,4,2.25,1930,7925,1.0,3,1300,630,98155
347500.0,4,2.5,1970,7098,2.0,3,1970,0,98038
525000.0,4,1.75,1570,16697,1.0,3,1030,540,98052
645000.0,4,2.25,2720,18295,1.0,4,2000,720,98075
390000.0,3,2.25,2420,31497,1.0,4,1750,670,98058
267500.0,3,2.5,1400,7629,1.0,3,1120,280,98030
380000.0,3,2.25,2530,12042,2.0,3,2530,0,98042
464000.0,3,1.75,1630,28600,1.0,3,1630,0,98072
280927.0,4,2.25,2070,7350,2.0,4,2070,0,98032
575550.0,4,2.5,2060,7475,1.0,3,1440,620,98052
259900.0,3,2.0,1490,7770,1.0,4,1490,0,98042
450000.0,4,2.25,2120,8267,2.0,3,2120,0,98045
275000.0,4,2.25,2400,17842,2.0,4,2400,0,98002
305000.0,3,2.5,2460,5027,2.0,3,2460,0,98042
410000.0,3,2.0,1320,6000,1.5,4,1320,0,98144
500000.0,4,2.0,2280,7200,1.0,4,2280,0,98133
175000.0,4,2.5,1780,6000,2.0,3,1780,0,98198
305000.0,4,2.25,2050,12581,2.0,4,2050,0,98002
661000.0,3,2.5,1940,8196,2.0,3,1940,0,98052
247000.0,3,1.75,1820,8740,1.0,4,1820,0,98023
453000.0,3,1.75,1550,7200,1.0,3,1100,450,98125
257100.0,3,1.5,1500,10227,1.0,4,1000,500,98022
540000.0,3,1.75,1610,3478,1.5,4,1060,550,98117
268000.0,3,1.75,1970,10270,1.0,4,1970,0,98032
545000.0,3,2.5,1940,9775,1.0,3,1440,500,98034
244000.0,3,2.0,1360,9688,1.0,4,1360,0,98003
340000.0,3,2.5,1720,4120,2.0,3,1720,0,98148
620000.0,3,1.5,1620,6630,1.0,3,1280,340,98117
325000.0,4,2.5,2040,5472,2.0,3,2040,0,98092
476100.0,4,2.5,1850,1836,2.0,3,1600,250,98029
220000.0,4,2.0,1620,5200,1.5,4,1620,0,98042
236000.0,3,1.75,1560,10919,1.0,3,1560,0,98023
283200.0,4,2.5,1982,6406,2.0,3,1982,0,98030
541500.0,3,1.75,2320,55847,1.0,4,2320,0,98001
420000.0,3,2.0,1640,9972,1.0,4,1640,0,98075
655000.0,4,2.25,2060,8470,1.0,3,1440,620,98006
240000.0,3,2.5,1500,10652,2.0,4,1500,0,98031
390000.0,4,1.5,1940,12100,1.0,3,1940,0,98033
511000.0,3,2.5,1820,4883,2.0,3,1820,0,98028
499990.0,3,1.75,1630,8400,1.0,4,1060,570,98007
322000.0,4,2.25,1940,10200,1.0,3,1360,580,98188
297300.0,3,1.75,1980,9220,2.0,3,1980,0,98092
230000.0,3,1.75,1260,10164,1.0,4,1260,0,98059
323800.0,3,2.5,2060,7658,2.0,3,2060,0,98023
574500.0,4,1.5,1430,6380,1.5,4,1430,0,98125
505000.0,3,2.25,1670,1596,2.0,3,1220,450,98199
425000.0,3,1.5,1300,19163,1.0,3,1300,0,98052
265000.0,4,2.5,1820,16103,2.0,3,1820,0,98030
399888.0,4,2.25,1820,8255,1.5,4,1320,500,98133
554990.0,3,2.5,2100,6092,2.0,3,2100,0,98028
359950.0,3,2.5,2210,6280,2.0,3,2210,0,98038
479950.0,4,2.25,2570,11070,2.0,4,2570,0,98058
392000.0,4,2.25,2360,7733,2.0,3,2360,0,98058
760500.0,4,2.25,2310,36136,2.0,4,2310,0,98072
435000.0,3,2.5,2300,9521,2.0,3,2300,0,98019
331950.0,4,2.5,2530,9933,2.0,3,2010,520,98092
514000.0,3,1.75,1720,5899,1.0,3,1220,500,98136
643403.0,3,2.5,2350,9648,1.0,4,2350,0,98008
357000.0,4,2.5,2380,7066,2.0,4,2380,0,98031
865000.0,3,1.75,1480,8163,1.0,3,1040,440,98004
265000.0,3,1.5,1290,7100,1.0,3,1290,0,98198
460500.0,4,2.5,2170,7533,2.0,3,2170,0,98059
315000.0,4,1.75,1850,8580,1.0,3,1140,710,98178
479000.0,4,2.5,2590,6139,2.0,3,2590,0,98038
641000.0,4,2.5,2600,6015,2.0,3,2600,0,98075
260750.0,3,2.0,1560,9635,1.0,3,1260,300,98003
601000.0,4,2.5,2080,5191,2.0,3,2080,0,98075
255000.0,3,1.5,1490,6604,1.0,4,1490,0,98166
555000.0,4,2.75,2020,10720,1.0,4,1420,600,98052
865000.0,3,1.5,1530,10827,1.0,4,1530,0,98039
229950.0,3,1.75,1900,8910,2.0,4,1900,0,98092
349000.0,3,1.75,1740,7682,1.0,3,1330,410,98058
348000.0,4,2.5,2070,3808,2.0,3,2070,0,98058
265000.0,3,1.5,1520,6805,1.0,4,1040,480,98023
638000.0,3,2.5,2110,3600,2.0,3,2110,0,98052
440000.0,3,1.75,1170,8740,1.0,4,1170,0,98052
555000.0,3,2.5,2160,7584,2.0,3,2160,0,98029
272000.0,3,2.5,1980,6608,2.0,3,1980,0,98092
690000.0,3,1.5,1710,17707,1.0,4,1180,530,98040
256000.0,4,1.75,1270,6825,1.0,3,1270,0,98178
259000.0,3,1.75,1240,4000,1.0,3,1240,0,98055
485000.0,3,2.5,1760,3097,2.0,3,1760,0,98029
259500.0,3,2.0,1330,35060,1.0,3,1330,0,98092
354000.0,4,2.5,2340,5420,2.0,3,2340,0,98038
300000.0,3,2.5,1750,4200,2.0,3,1750,0,98038
309950.0,4,2.5,1770,6666,2.0,3,1770,0,98023
329000.0,3,2.0,1840,6755,1.0,3,1840,0,98003
246000.0,4,1.75,1720,7455,1.0,4,1020,700,98058
405000.0,3,1.5,1280,9600,1.0,4,1280,0,98033
374950.0,4,2.5,1980,12062,2.0,3,1980,0,98031
560000.0,3,2.5,1960,12476,2.0,4,1960,0,98056
306500.0,3,2.25,2060,38377,1.0,4,1560,500,98003
299950.0,3,1.75,1980,11274,1.0,4,1480,500,98058
265500.0,3,2.5,1450,8977,1.0,3,1450,0,98092
219000.0,3,1.5,1200,12000,1.0,3,1200,0,98001
365000.0,3,1.75,1830,17349,1.0,3,1230,600,98072
499000.0,3,2.0,2090,42689,1.5,3,2090,0,98010
366000.0,3,1.75,1510,8301,1.0,3,1510,0,98034
315000.0,3,2.5,1660,10763,2.0,3,1660,0,98038
505000.0,3,1.75,1640,10695,1.0,3,1640,0,98034
567500.0,3,2.5,2300,7398,2.0,3,2300,0,98065
265000.0,3,1.5,1460,8505,1.0,4,1460,0,98055
340000.0,3,2.0,1570,14992,1.0,3,1570,0,98014
850000.0,4,2.25,2130,11843,2.0,4,2130,0,98040
675000.0,3,2.5,2250,4134,2.0,3,2250,0,98052
263500.0,3,1.75,1610,14000,1.0,4,1050,560,98010
550000.0,4,2.25,2590,36256,2.0,3,2590,0,98077
875000.0,3,2.5,2520,3750,2.0,4,2520,0,98116
240000.0,3,1.75,1380,7500,1.0,3,1380,0,98038
490000.0,3,1.75,1510,11120,1.0,4,1510,0,98005
350000.0,3,2.5,1970,3655,2.0,3,1970,0,98019
284200.0,3,1.75,1540,6632,1.0,3,1070,470,98178
616500.0,4,2.25,1880,3000,2.0,3,1760,120,98103
230000.0,4,1.75,1850,6000,1.0,4,1270,580,98178
372000.0,4,2.75,2330,14175,1.0,3,1800,530,98031
306000.0,4,2.5,1880,9426,2.0,4,1880,0,98042
280000.0,3,1.75,1630,10001,1.0,4,1100,530,98042
425000.0,3,2.5,1930,4500,2.0,3,1930,0,98029
491000.0,3,2.0,1660,5070,2.0,3,1660,0,98108
830000.0,4,2.5,1850,50662,1.0,3,1430,420,98052
818000.0,4,2.25,2460,8001,2.0,4,2460,0,98006
431000.0,3,2.25,2360,14950,1.0,4,2360,0,98042
565000.0,4,2.5,2280,9725,2.0,3,2280,0,98072
629000.0,3,1.75,1460,12367,2.0,4,1120,340,98023
330000.0,3,1.75,2020,11050,1.0,4,1320,700,98059
360000.0,4,2.5,2390,7056,2.0,3,2390,0,98001
378000.0,3,2.5,2150,11672,2.0,3,2150,0,98038
499950.0,3,1.75,1340,6250,1.0,4,1090,250,98136
450000.0,3,2.5,1990,12866,2.0,4,1990,0,98072
290000.0,3,2.5,2080,4828,2.0,3,2080,0,98042
311000.0,4,2.5,1780,5822,2.0,3,1780,0,98058
332500.0,3,2.0,1600,7995,1.0,3,1600,0,98118
371000.0,3,1.75,1570,15330,1.0,3,1080,490,98166
264500.0,3,1.75,1650,16200,1.0,3,1650,0,98031
738000.0,4,2.5,2830,5010,2.0,3,2170,660,98115
241000.0,3,1.5,1660,8000,1.0,4,1120,540,98030
530000.0,3,1.75,1520,9605,1.0,3,1520,0,98052
487000.0,3,1.75,1770,10125,2.0,3,1770,0,98133
679000.0,3,2.5,1780,4320,2.0,4,1780,0,98115
386000.0,3,1.5,1270,1318,2.0,3,1080,190,98199
335000.0,3,1.75,1260,17000,1.0,3,1260,0,98146
472500.0,3,2.0,1750,15500,1.0,3,1490,260,98075
290000.0,3,2.5,2000,7414,2.0,4,2000,0,98038
192500.0,3,1.75,1420,7205,1.0,3,1420,0,98030
350000.0,4,2.0,2060,13400,1.0,4,2060,0,98166
645000.0,3,2.5,1740,13750,2.0,4,1740,0,98008
605000.0,4,2.5,2520,3980,2.0,3,2520,0,98027
535000.0,3,2.75,2490,3600,2.0,3,2290,200,98122
429950.0,4,2.25,1740,10875,1.0,3,1740,0,98059
275000.0,3,1.5,1240,9125,1.0,4,1240,0,98058
495000.0,4,2.25,1940,9144,1.0,4,1430,510,98007
397500.0,3,2.0,2130,8225,1.0,4,2130,0,98058
420000.0,3,2.25,1770,8165,2.0,3,1770,0,98034
308950.0,3,2.5,1600,6250,2.0,3,1600,0,98038
237200.0,3,1.5,1220,9000,1.0,4,1220,0,98042
215000.0,3,1.5,1500,15000,1.0,3,1500,0,98031
440000.0,4,2.5,2410,4780,2.0,3,2410,0,98065
280000.0,3,2.25,1610,10454,1.0,3,1610,0,98148
290000.0,3,2.25,1880,7488,2.0,3,1880,0,98032
234000.0,3,1.75,1480,8475,1.0,4,1480,0,98023
597400.0,4,2.5,2420,4500,2.0,3,2420,0,98053
342000.0,3,2.5,2430,5715,2.0,3,2430,0,98030
205000.0,3,2.5,1870,3118,2.0,3,1870,0,98038
632750.0,4,2.0,1800,4800,1.5,3,1800,0,98112
388500.0,4,2.5,1890,5395,2.0,3,1890,0,98065
530000.0,3,1.75,1680,7770,1.0,4,1680,0,98005
419000.0,3,2.5,2170,4517,2.0,3,2170,0,98059
385000.0,3,1.75,1200,7360,1.0,4,1200,0,98052
262000.0,3,1.5,1700,9579,1.0,4,1100,600,98023
640000.0,3,1.75,1680,8100,1.0,3,1680,0,98177
285000.0,3,2.25,1680,35127,2.0,3,1680,0,98092
458400.0,4,2.5,1910,10300,1.0,3,1910,0,98177
369950.0,4,2.5,1910,10221,2.0,3,1910,0,98038
418000.0,4,1.5,1220,10580,1.0,3,1220,0,98008
457000.0,4,2.5,2200,10800,1.0,3,1500,700,98155
491000.0,3,1.75,1440,7800,1.0,4,1440,0,98008
521000.0,4,2.25,1890,8034,1.0,4,1890,0,98008
291600.0,3,1.75,1630,7480,1.0,3,1330,300,98058
238000.0,3,1.5,1610,6132,1.0,4,1090,520,98056
455000.0,4,2.5,1320,7000,1.0,4,1320,0,98008
517500.0,3,2.5,1800,3933,2.0,3,1800,0,98029
579500.0,3,1.75,1250,4120,1.0,4,980,270,98117
689000.0,4,2.5,2110,6069,2.0,3,2110,0,98052
325000.0,4,2.75,2090,9240,1.0,4,2090,0,98146
262000.0,3,2.5,1970,8727,2.0,3,1970,0,98092
425590.0,3,2.75,1940,3088,2.0,3,1770,170,98065
252000.0,3,2.0,1370,7500,1.0,3,1370,0,98038
249900.0,4,2.0,1500,7854,1.5,3,1500,0,98023
510000.0,4,2.5,2010,9075,1.0,4,1310,700,98006
652500.0,4,2.5,2540,38677,2.0,3,2540,0,98053
220000.0,4,1.5,1240,9600,1.0,3,1240,0,98023
325000.0,3,1.75,1840,17286,1.0,4,1440,400,98030
380000.0,4,1.75,2030,12518,1.0,3,1610,420,98125
579000.0,4,2.25,2030,8764,2.0,4,2030,0,98052
499000.0,3,1.75,1750,12325,1.0,4,1470,280,98052
520000.0,3,2.75,1700,3264,1.0,3,1060,640,98115
270000.0,3,2.25,1470,16728,1.0,4,1350,120,98168
650000.0,3,1.75,1550,5000,1.0,3,1250,300,98107
397000.0,4,2.5,2320,11717,2.0,3,2320,0,98045
383610.0,3,2.0,1230,8450,1.0,3,1230,0,98155
275000.0,4,2.5,2060,5742,2.0,3,2060,0,98030
365000.0,4,2.5,2140,7350,2.0,3,2140,0,98058
362000.0,3,2.75,1420,955,2.0,3,1160,260,98029
350000.0,3,1.75,2090,6258,1.0,3,1390,700,98108
464000.0,4,2.5,2180,7203,2.0,4,2180,0,98059
255000.0,3,1.75,1740,8800,1.0,3,1140,600,98023
289659.0,4,2.25,2260,7200,2.0,4,2260,0,98031
460000.0,3,2.0,1600,7350,1.0,4,1600,0,98052
319000.0,3,2.5,2110,7434,2.0,4,2110,0,98031
280000.0,3,2.5,1720,1916,2.0,3,1720,0,98059
465000.0,3,2.5,1890,4808,2.0,3,1890,0,98065
580000.0,3,1.75,1850,2797,1.0,3,1150,700,98103
350000.0,4,2.5,2506,7206,2.0,3,2506,0,98023
290000.0,3,2.0,1550,18958,1.5,3,1550,0,98198
285000.0,3,2.5,1890,3629,2.0,3,1890,0,98038
219000.0,3,2.25,1940,6500,1.0,3,1440,500,98042
546500.0,3,2.5,2130,7199,2.0,3,2130,0,98074
800000.0,3,1.75,1890,10292,1.0,4,1890,0,98040
252000.0,3,1.75,1440,16819,1.5,4,1440,0,98023
245000.0,3,2.0,1690,6790,1.0,3,1360,330,98023
493500.0,3,1.75,1800,16026,1.0,3,1390,410,98008
596500.0,4,2.25,1770,8505,2.0,3,1770,0,98052
333500.0,3,1.75,1320,7200,1.0,4,1320,0,98028
408000.0,3,2.0,1640,3440,2.0,3,1640,0,98052
339000.0,4,2.5,1740,6000,1.0,4,1740,0,98178
445000.0,3,2.25,1990,7340,2.0,3,1990,0,98072
605000.0,4,1.75,2250,10108,1.0,4,2250,0,98008
251000.0,3,2.0,1300,8400,1.0,4,1300,0,98198
597000.0,4,2.5,2370,41338,2.0,3,2370,0,98077
357000.0,3,1.75,1250,17493,1.0,3,1250,0,98155
419990.0,3,2.5,1690,1689,2.0,3,1150,540,98029
445000.0,3,2.25,1190,13630,1.0,3,1190,0,98045
510000.0,3,2.5,2300,27566,2.0,3,2300,0,98019
495000.0,4,2.0,1610,4770,1.0,4,1230,380,98126
225000.0,4,1.75,1420,10300,2.0,3,1420,0,98002
716528.0,3,1.5,1750,5400,1.0,4,1050,700,98115
260000.0,3,2.5,1510,6095,2.0,4,1510,0,98038
471000.0,4,2.5,2330,9928,2.0,3,2330,0,98045
682000.0,4,2.25,2450,34092,2.0,4,2450,0,98075
605000.0,3,2.25,2010,10760,2.0,3,2010,0,98052
383150.0,3,2.0,2210,6387,1.0,3,2210,0,98003
539000.0,3,2.0,1800,43995,2.0,3,1800,0,98077
700000.0,4,1.75,1980,10800,1.0,4,1320,660,98005
515000.0,3,2.5,1800,5001,2.0,3,1800,0,98034
685000.0,4,2.0,2260,10800,1.0,3,2260,0,98007
292500.0,4,2.5,1610,4568,2.0,3,1610,0,98001
550000.0,3,2.5,1740,3082,2.0,3,1740,0,98029
457500.0,3,2.25,1430,2003,2.0,3,980,450,98144
224097.0,3,1.5,1420,8580,1.0,3,1420,0,98023
254000.0,3,2.5,1560,10608,2.0,3,1560,0,98042
350000.0,3,1.75,1360,18123,1.0,3,1360,0,98045
432500.0,3,2.5,1940,10800,1.0,3,1340,600,98077
233703.0,3,2.25,1650,3788,2.0,3,1650,0,98031
735000.0,3,2.5,2540,6762,2.0,3,2540,0,98007
257000.0,3,1.75,1800,9000,1.0,3,1200,600,98178
225000.0,4,2.0,1750,7245,1.0,4,1050,700,98092
355000.0,3,2.5,1590,4242,2.0,3,1590,0,98065
382500.0,4,1.75,1560,8700,1.0,4,1560,0,98034
324360.0,3,2.5,2000,9669,2.0,4,2000,0,98022
315000.0,3,1.75,2380,10450,1.5,3,2380,0,98023
295000.0,4,2.5,2030,5754,2.0,3,2030,0,98042
720001.0,3,2.5,1430,2200,1.5,4,1430,0,98103
305000.0,3,1.75,1610,12247,1.0,3,1610,0,98058
625000.0,3,1.5,1600,4128,1.5,3,1250,350,98122
269950.0,3,2.0,1660,8641,2.0,4,1660,0,98042
480000.0,4,2.5,2480,5100,2.0,3,2480,0,98019
426950.0,4,2.75,2350,5589,2.0,3,2350,0,98059
550000.0,4,2.75,1690,6090,1.5,3,1400,290,98115
451000.0,4,2.5,2320,5375,2.0,3,2320,0,98065
562000.0,4,2.25,2170,7007,1.0,3,1540,630,98033
583000.0,3,1.75,1930,10183,1.0,4,1480,450,98006
595000.0,4,2.25,2050,8372,2.0,4,2050,0,98052
488500.0,3,2.75,1820,9490,2.0,3,1820,0,98011
260000.0,4,2.5,2110,8990,2.0,3,2110,0,98058
335620.0,3,2.25,1800,15903,1.0,3,1340,460,98038
464000.0,4,2.25,2220,15232,1.0,3,1690,530,98072
285000.0,3,2.25,1840,9040,1.0,3,1370,470,98023
370000.0,4,2.5,2220,5338,2.0,3,2220,0,98059
399900.0,3,1.75,1260,12750,1.0,3,1260,0,98034
450000.0,3,1.5,1530,23660,1.0,3,1530,0,98155
524000.0,3,2.25,2140,6720,1.0,3,1440,700,98117
880000.0,4,2.5,2340,10800,1.0,3,2340,0,98040
554500.0,3,2.25,1880,6565,1.0,4,1420,460,98008
500000.0,3,2.5,1650,5683,2.0,3,1650,0,98053
247800.0,3,2.5,1580,2170,2.0,3,1580,0,98118
344200.0,4,2.5,2490,5812,2.0,3,2490,0,98042
459950.0,4,2.5,2000,6107,2.0,3,2000,0,98011
229900.0,4,1.75,1550,9899,1.0,4,1550,0,98030
785000.0,4,2.75,2900,17400,1.0,4,2410,490,98052
324000.0,3,2.5,1940,8347,2.0,3,1940,0,98042
500000.0,4,2.25,2490,23478,2.0,3,2490,0,98072
385000.0,3,1.75,2310,11200,1.0,4,1630,680,98030
395000.0,3,2.5,2310,4930,2.0,4,2310,0,98055
375000.0,4,2.25,2100,12738,2.0,4,2100,0,98059
600000.0,3,2.75,2080,16740,1.0,3,1580,500,98198
375000.0,4,1.75,1890,8000,1.0,4,1250,640,98133
429000.0,3,2.5,1860,11122,2.0,3,1860,0,98059
276200.0,3,2.5,1480,7210,1.0,3,1180,300,98023
730000.0,4,2.5,2030,4080,1.5,4,1730,300,98115
490000.0,3,1.75,1770,7508,1.0,3,1270,500,98133
645500.0,4,2.5,2390,9638,2.0,3,2390,0,98029
750000.0,3,2.0,1760,5488,1.5,3,1540,220,98119
344900.0,4,1.75,1820,7700,1.0,4,1100,720,98177
575000.0,4,2.0,1810,4400,2.0,3,1700,110,98122
518000.0,4,2.75,2520,14021,2.0,3,2520,0,98019
285000.0,3,2.5,1590,9736,2.0,3,1590,0,98001
399000.0,3,1.75,1780,11440,1.0,3,1350,430,98059
406500.0,3,1.5,1970,10080,1.0,3,1970,0,98168
422800.0,3,1.75,1820,8400,1.0,3,1340,480,98072
525000.0,3,2.0,1620,7800,1.0,3,1200,420,98034
439950.0,3,2.0,1230,1613,2.0,3,1010,220,98107
359000.0,4,2.5,2160,4500,2.0,3,2160,0,98056
330000.0,3,1.75,1590,9417,1.0,4,1590,0,98177
640000.0,3,2.5,2420,8244,2.0,3,2420,0,98029
570000.0,3,2.25,2180,9246,2.0,3,2180,0,98074
350000.0,3,2.5,2180,15484,1.0,3,2180,0,98003
690000.0,4,2.5,2120,8448,2.0,4,2120,0,98029
375000.0,4,2.5,2210,9427,2.0,3,2210,0,98148
575000.0,4,2.5,2510,47044,2.0,3,2510,0,98077
239950.0,3,2.5,1560,4800,2.0,4,1560,0,98001
240000.0,3,2.0,1310,8069,1.0,3,1310,0,98042
650000.0,3,1.75,1840,2310,1.0,4,1140,700,98109
402500.0,3,1.75,1480,2211,2.0,3,1480,0,98103
482000.0,3,2.5,2420,7307,2.0,3,2420,0,98065
350000.0,3,2.5,1630,5996,2.0,3,1630,0,98055
654300.0,3,2.5,2490,8582,2.0,3,2490,0,98074
855000.0,4,2.0,2380,10800,2.0,3,2380,0,98118
290000.0,4,2.25,1900,10950,1.0,4,1400,500,98032
450000.0,3,1.75,1810,12600,1.0,3,1400,410,98034
450000.0,3,1.75,1360,5445,1.0,4,1360,0,98008
285000.0,4,2.25,1970,7200,2.0,3,1970,0,98092
290000.0,3,2.5,2020,4861,2.0,3,2020,0,98058
292000.0,3,2.5,1560,2740,2.0,3,1560,0,98059
617450.0,3,2.0,1580,14398,1.0,3,1080,500,98005
348000.0,3,1.75,1720,8867,1.0,3,1320,400,98058
550000.0,3,2.0,1810,4064,1.5,3,1810,0,98103
347500.0,3,2.5,1890,7053,2.0,4,1890,0,98031
397000.0,4,1.75,2020,6000,1.0,3,1620,400,98144
410000.0,4,1.75,1790,11875,1.0,4,1490,300,98027
476000.0,3,2.25,1630,3070,2.0,3,1630,0,98053
390000.0,3,1.75,1180,16552,1.0,4,1180,0,98072
226500.0,3,2.0,1560,7000,1.0,4,1560,0,98001
495000.0,3,2.0,1340,2550,2.0,3,1340,0,98117
535950.0,3,2.5,2370,5344,2.0,3,2370,0,98065
495000.0,3,1.75,1440,11787,1.0,3,1440,0,98074
400000.0,4,2.25,1970,8941,2.0,3,1970,0,98034
342000.0,3,2.0,2250,7757,1.0,3,2250,0,98003
850000.0,3,2.0,1540,3600,2.0,3,1540,0,98112
470000.0,4,2.5,2310,14023,2.0,3,2310,0,98019
366000.0,3,1.75,1840,11440,1.0,4,1340,500,98059
545000.0,3,2.5,2060,7184,2.0,3,2060,0,98029
500000.0,3,1.75,1800,7199,1.0,3,1300,500,98125
384950.0,3,2.5,1860,3690,2.0,3,1860,0,98028
184500.0,3,1.5,1280,3640,2.0,3,1280,0,98002
570000.0,3,2.5,1530,3296,2.0,3,1530,0,98007
850000.0,4,1.75,2350,11914,1.0,4,2350,0,98040
327000.0,4,1.75,1840,5100,1.0,4,1840,0,98056
369500.0,3,1.5,1650,9957,1.0,4,1100,550,98125
440000.0,3,1.75,1760,8025,1.0,4,1230,530,98034
660000.0,4,1.5,1960,4500,1.5,3,1960,0,98117
440000.0,3,1.75,2000,11880,2.0,3,2000,0,98075
343888.0,4,2.5,2060,5607,2.0,3,2060,0,98058
500000.0,4,1.75,2240,9886,1.5,4,2240,0,98008
640000.0,3,2.5,2140,8925,2.0,3,2140,0,98074
360000.0,3,2.5,1480,3851,2.0,3,1480,0,98072
290500.0,4,2.5,1680,3000,2.0,3,1680,0,98178
433000.0,4,2.5,2280,7568,2.0,4,2280,0,98056
309950.0,4,2.75,2310,5000,2.0,3,2310,0,98038
280000.0,3,1.75,1630,11800,1.0,4,1630,0,98045
345000.0,3,2.25,2020,9000,2.0,3,2020,0,98045
350000.0,4,2.5,2500,5831,2.0,3,2500,0,98038
730000.0,3,1.75,2040,11294,1.0,4,1340,700,98004
266200.0,3,1.5,1430,9600,1.0,4,1430,0,98059
430000.0,3,1.75,1300,12731,1.0,3,1300,0,98074
650000.0,4,2.25,2560,9731,2.0,4,2560,0,98034
379900.0,3,2.5,2190,5071,2.0,3,2190,0,98038
455000.0,4,2.25,1740,8449,1.0,4,1170,570,98008
373000.0,3,1.75,1310,7811,1.0,3,1310,0,98034
502000.0,3,2.0,1300,14350,1.0,3,1300,0,98006
362500.0,3,2.0,1940,40588,1.0,3,1940,0,98058
580000.0,4,2.5,2110,11680,1.0,4,1420,690,98052
278000.0,3,2.25,1590,9425,1.0,3,1170,420,98058
783200.0,4,2.0,1590,5400,1.0,3,990,600,98119
472217.0,3,2.5,2010,2212,2.0,3,1390,620,98029
244615.0,3,2.5,2060,4030,2.0,3,2060,0,98032
489950.0,3,2.5,2400,7478,2.0,3,2400,0,98019
652000.0,3,2.25,1920,9600,1.0,4,1560,360,98052
333000.0,4,2.5,1910,9244,1.0,4,1910,0,98059
560000.0,3,1.5,2000,7350,1.0,3,2000,0,98177
449500.0,4,2.5,2410,55931,2.0,3,2410,0,98092
267500.0,3,2.25,2080,2856,1.5,3,1550,530,98042
396800.0,4,2.5,2200,6018,2.0,3,2200,0,98019
892500.0,3,1.75,2120,56192,1.0,3,1720,400,98177
455500.0,3,2.0,1460,10311,1.0,4,1460,0,98052
743000.0,3,1.75,2110,11250,1.0,4,2110,0,98040
338000.0,4,1.5,1790,17925,1.0,4,1790,0,98155
332000.0,3,1.75,1340,13115,1.0,3,1340,0,98045
739000.0,3,2.5,2750,16000,2.0,4,2560,190,98033
435000.0,3,2.5,2530,13446,2.0,3,2530,0,98019
520000.0,4,2.75,2020,7357,1.0,3,1350,670,98034
440000.0,3,1.5,1690,6010,1.0,3,1230,460,98115
250000.0,3,1.5,1170,9848,1.0,3,1170,0,98028
425000.0,3,2.25,1800,7371,1.0,3,1280,520,98072
285000.0,3,1.75,1560,9514,1.0,4,1560,0,98031
304500.0,3,2.25,1790,6930,1.0,3,1390,400,98003
288000.0,3,1.5,1300,7313,1.0,4,1300,0,98055
417000.0,3,1.75,1920,9512,1.0,3,1440,480,98011
452500.0,3,1.75,2040,15695,1.0,4,2040,0,98166
653000.0,4,2.5,2160,7000,2.0,4,2160,0,98029
541000.0,3,1.75,1410,4080,1.5,4,1410,0,98105
245000.0,4,1.5,1850,7547,1.5,4,1850,0,98198
216000.0,3,1.75,1310,8670,1.0,4,1310,0,98092
443000.0,3,1.75,1640,4579,1.0,4,1640,0,98133
257700.0,4,2.25,1600,6202,2.0,4,1600,0,98038
300000.0,3,2.5,2240,3691,2.0,3,2240,0,98092
269100.0,3,2.5,2190,7904,2.0,3,2190,0,98092
525000.0,4,2.5,2310,5573,2.0,4,2310,0,98056
350000.0,3,2.25,1550,5401,2.0,3,1550,0,98019
410000.0,4,2.5,2070,6180,2.0,3,2070,0,98056
499000.0,3,2.5,1690,4851,2.0,3,1690,0,98053
340000.0,4,2.5,2550,7555,2.0,3,2550,0,98001
345000.0,4,2.5,2382,5899,2.0,3,2382,0,98003
280500.0,3,2.25,1620,7566,2.0,3,1620,0,98038
545000.0,3,2.5,2140,40173,2.0,4,2140,0,98027
274900.0,4,1.75,1840,10528,1.0,3,1210,630,98023
499950.0,4,2.5,2860,3345,2.0,3,2190,670,98072
415250.0,3,1.5,1400,7550,1.0,4,1400,0,98133
300000.0,3,2.5,1640,5707,2.0,3,1640,0,98031
420000.0,3,2.5,2370,15375,2.0,3,2370,0,98042
575000.0,3,2.5,2610,7301,2.0,3,2610,0,98072
428000.0,4,2.0,1300,7200,1.0,3,1300,0,98122
260000.0,3,2.5,1770,2677,2.0,3,1770,0,98055
238000.0,3,1.5,1360,7488,1.0,4,1050,310,98001
265000.0,3,2.25,1510,6071,1.0,4,1150,360,98042
360000.0,3,1.75,1950,7260,1.0,3,1520,430,98133
345000.0,4,2.5,2040,5875,2.0,3,2040,0,98056
612500.0,4,2.0,1690,35346,1.0,3,1690,0,98008
317000.0,3,1.75,1530,7650,1.0,4,1530,0,98058
585000.0,3,1.5,1810,3880,1.5,4,1310,500,98117
455000.0,3,1.75,1180,14292,1.0,3,1180,0,98045
497000.0,4,2.25,2250,3463,2.0,4,2250,0,98052
385000.0,4,2.0,1820,7102,1.0,3,1220,600,98155
371000.0,4,2.5,2550,4770,2.0,3,2550,0,98038
545000.0,4,2.5,2080,8504,2.0,3,2080,0,98029
289571.0,3,1.5,1340,25160,1.0,3,1340,0,98059
440000.0,4,2.75,2340,11034,1.0,3,1720,620,98155
400000.0,3,1.5,1510,8360,1.0,3,1120,390,98007
470000.0,3,2.5,2480,5082,2.0,3,2480,0,98065
240000.0,3,2.5,1520,9864,1.0,3,1160,360,98092
445500.0,4,1.5,2210,10497,1.0,4,1650,560,98166
720000.0,3,2.5,2520,10012,2.0,3,2520,0,98074
600000.0,3,1.75,1310,5000,2.0,4,1310,0,98107
515000.0,3,2.5,1790,7167,2.0,3,1790,0,98074
630000.0,3,1.75,1710,8767,1.0,4,1710,0,98033
410000.0,3,1.75,2000,7480,1.0,3,1320,680,98177
602000.0,3,2.25,1580,11580,1.0,4,1580,0,98006
700500.0,3,2.5,2560,35265,2.0,3,2560,0,98072
250000.0,3,2.0,1660,13085,1.0,3,1010,650,98001
450000.0,4,2.25,1710,7000,1.0,4,1040,670,98034
392000.0,3,1.5,1500,11975,1.0,4,1500,0,98045
209000.0,3,1.75,1250,8084,1.0,4,1250,0,98001
485000.0,4,2.5,2400,10364,2.0,3,2400,0,98045
429000.0,3,2.5,1430,9240,2.0,3,1430,0,98074
729000.0,3,2.5,2480,7428,2.0,3,2480,0,98006
625000.0,3,2.5,2280,4757,2.0,3,2280,0,98075
218500.0,3,1.75,1390,9328,1.0,4,1390,0,98092
480000.0,3,2.0,1300,3000,2.0,3,1300,0,98115
432500.0,3,1.75,1470,7350,1.0,3,1470,0,98052
598850.0,4,2.5,2350,7245,2.0,3,2350,0,98074
515700.0,3,2.5,2180,9722,2.0,3,2180,0,98056
458000.0,3,2.5,1870,5013,2.0,3,1870,0,98011
653750.0,4,2.5,2460,4166,2.0,3,2460,0,98034
299000.0,3,2.5,1650,4725,2.0,3,1650,0,98038
608700.0,4,2.5,2260,9696,1.0,3,2260,0,98074
700000.0,4,2.5,2672,4297,2.0,3,2020,652,98115
229500.0,3,1.5,1810,14400,1.0,4,1810,0,98001
265000.0,3,2.25,1450,13439,1.0,4,1180,270,98003
548500.0,4,2.0,1820,7200,1.0,3,1300,520,98136
615000.0,3,1.75,2350,20820,1.0,4,1800,550,98074
292000.0,3,1.75,1320,6600,1.0,3,1320,0,98168
580000.0,3,2.5,1910,11550,1.5,3,1910,0,98074
275000.0,3,1.75,1180,6260,1.0,4,1180,0,98038
390000.0,3,2.25,1820,7420,2.0,4,1820,0,98058
250000.0,3,2.25,1560,15340,2.0,3,1560,0,98168
232000.0,3,1.5,1390,11340,1.0,4,1390,0,98031
310000.0,3,1.75,1880,30346,1.0,3,1880,0,98001
750000.0,4,1.5,2060,4000,1.5,3,1580,480,98103
392500.0,4,2.5,2150,7303,2.0,3,2150,0,98056
735000.0,3,2.5,2390,9157,2.0,3,2390,0,98052
575000.0,4,2.5,2400,6137,2.0,3,2400,0,98074
291000.0,4,2.5,1580,6633,2.0,4,1580,0,98042
475000.0,3,2.0,1880,9659,1.0,3,1180,700,98155
440000.0,3,2.5,2040,7605,2.0,3,2040,0,98045
656000.0,4,1.75,1440,4300,1.5,4,1290,150,98117
559950.0,3,2.5,2120,4310,2.0,3,2120,0,98053
210750.0,4,1.5,1840,7076,1.5,3,1840,0,98106
390000.0,3,2.5,2250,8076,2.0,3,2250,0,98038
405000.0,3,2.5,2460,12600,1.0,4,1810,650,98059
435000.0,4,2.25,2210,14073,1.0,3,1630,580,98059
440000.0,3,2.5,1440,5434,2.0,3,1440,0,98053
299950.0,3,1.75,1790,7650,1.0,3,1790,0,98023
312620.0,3,2.5,1260,11877,1.0,3,1260,0,98045
297262.0,3,2.5,1730,8076,2.0,3,1730,0,98003
430000.0,3,1.5,1550,5034,2.0,4,1550,0,98177
538000.0,4,1.75,1840,9600,1.0,3,1220,620,98052
729000.0,3,2.5,2440,4244,2.0,3,2440,0,98052
245000.0,3,2.0,1700,8448,1.0,3,1700,0,98022
427000.0,3,1.75,2000,7111,1.0,4,1360,640,98177
294900.0,3,2.25,1500,8100,1.0,3,1210,290,98055
199500.0,4,2.0,1750,8116,1.0,4,1750,0,98056
247000.0,4,2.0,1750,8116,1.0,4,1750,0,98056
442500.0,4,2.5,2170,14024,2.0,3,2170,0,98019
449000.0,3,2.5,1690,3827,2.0,3,1690,0,98053
305000.0,4,2.25,2210,9371,2.0,4,2210,0,98032
360000.0,3,1.75,1520,12282,1.0,3,1220,300,98155
235000.0,3,1.75,1200,9266,1.0,4,1200,0,98002
550000.0,3,1.75,1830,9720,1.0,3,1150,680,98040
420000.0,3,2.0,1750,9239,1.0,3,1410,340,98133
450000.0,4,2.5,2400,7693,2.0,3,2400,0,98059
272000.0,4,2.25,2115,6234,2.0,3,2115,0,98002
481000.0,3,2.0,2580,15653,1.5,3,2580,0,98166
475000.0,3,2.5,1690,2890,2.0,3,1690,0,98053
291000.0,4,2.25,1890,7616,1.0,4,1260,630,98003
442500.0,3,2.5,1690,3129,2.0,3,1690,0,98053
875000.0,4,1.5,1800,3245,1.5,4,1800,0,98103
571000.0,3,2.5,1920,3867,2.0,3,1920,0,98029
525000.0,3,2.5,2340,35021,1.0,3,2340,0,98038
271000.0,4,1.5,1800,9576,1.0,4,1800,0,98045
280000.0,4,2.5,2400,4596,2.0,3,2400,0,98001
375000.0,3,2.0,1670,13775,1.0,3,1670,0,98045
178000.0,4,1.5,1200,11163,1.5,4,1200,0,98092
262500.0,3,1.75,1470,10390,1.0,3,1470,0,98031
730000.0,3,1.75,1650,5000,1.5,4,1650,0,98107
299990.0,3,2.5,1870,8541,2.0,3,1870,0,98023
580000.0,4,1.75,1720,6975,1.0,3,1420,300,98052
335000.0,3,1.75,1400,7920,1.0,3,1400,0,98034
660000.0,3,2.0,2570,28500,1.0,3,1970,600,98052
280000.0,3,2.5,1580,7918,2.0,3,1580,0,98055
324000.0,3,2.0,1540,10931,1.0,3,1540,0,98045
360000.0,3,1.75,1830,10000,2.0,4,1830,0,98019
600000.0,3,2.5,2260,10153,2.0,3,2260,0,98074
350000.0,4,1.75,2310,9002,1.0,3,1780,530,98034
186000.0,3,1.75,1460,7967,1.0,3,1040,420,98023
450000.0,3,2.25,1960,10682,1.0,3,1960,0,98008
469000.0,3,1.75,1480,800,2.0,3,1000,480,98136
268500.0,4,1.75,1820,13600,1.5,3,1120,700,98032
250000.0,3,2.0,1470,12096,1.0,4,1470,0,98030
325000.0,4,2.0,1870,7700,1.0,3,1870,0,98055
280000.0,3,2.5,1370,22326,2.0,3,1370,0,98045
450000.0,4,2.5,2520,8515,2.0,3,2520,0,98019
265000.0,3,1.75,1330,12618,1.0,3,1330,0,98188
398000.0,3,1.5,1310,2996,2.0,3,1310,0,98144
339950.0,4,2.5,2260,6086,2.0,3,2260,0,98030
350000.0,4,2.5,1530,2248,1.5,3,1530,0,98144
561000.0,3,2.5,2120,5277,2.0,3,2120,0,98053
314500.0,4,2.5,2390,9600,2.0,3,2390,0,98010
290000.0,3,2.5,2360,8764,2.0,3,2360,0,98022
499990.0,3,1.75,1730,9334,1.0,3,1220,510,98052
365000.0,3,1.75,1290,7205,1.5,3,1290,0,98034
368888.0,3,1.5,1490,12186,1.0,4,1490,0,98155
339500.0,4,2.5,1930,7862,2.0,3,1930,0,98038
450000.0,3,2.0,2320,17688,1.0,3,2320,0,98166
299900.0,4,2.5,2200,5730,2.0,3,2200,0,98042
315000.0,3,2.0,1500,7828,1.0,4,1500,0,98058
195000.0,3,1.5,1430,5200,1.0,4,1030,400,98042
306000.0,3,2.5,1870,5874,2.0,3,1870,0,98042
272000.0,4,2.25,2040,7600,1.0,4,1580,460,98023
450000.0,3,2.5,1990,12793,2.0,3,1990,0,98028
435000.0,4,2.5,2060,10125,2.0,4,1560,500,98028
485000.0,3,2.0,1590,11222,1.0,4,1590,0,98177
690000.0,3,1.5,1760,4000,2.0,3,1760,0,98102
305000.0,4,2.5,1620,4000,2.0,3,1620,0,98038
300000.0,3,1.75,1210,7000,1.0,3,1210,0,98058
575000.0,3,2.5,2270,9600,2.0,3,2270,0,98011
378000.0,3,2.5,2130,8404,2.0,3,2130,0,98058
629950.0,3,2.5,1680,1620,2.0,3,1120,560,98119
465000.0,4,1.75,1470,5350,1.0,3,980,490,98125
545000.0,4,2.25,2390,40510,1.0,4,2390,0,98072
592000.0,4,2.5,2300,11165,2.0,4,2300,0,98008
459950.0,4,1.75,2430,9747,1.0,3,1780,650,98155
485000.0,4,2.5,2470,35073,2.0,3,2470,0,98092
530000.0,3,1.75,1980,6760,1.0,4,1980,0,98008
394950.0,3,2.5,2050,8172,2.0,3,2050,0,98168
330000.0,3,2.25,1960,1985,2.0,3,1750,210,98118
220000.0,4,1.75,1910,8171,1.0,3,1910,0,98030
500000.0,3,2.25,2210,7680,1.0,3,1730,480,98177
253000.0,3,1.75,1570,7416,1.0,4,1570,0,98031
605000.0,3,1.75,1930,5400,2.0,3,1930,0,98177
256750.0,3,2.5,1990,8991,1.0,3,1570,420,98042
535000.0,3,2.5,1690,9626,2.0,3,1690,0,98027
515000.0,3,2.0,1810,2738,2.0,4,1810,0,98008
256000.0,3,2.5,1570,5113,1.0,3,1090,480,98001
220000.0,3,1.5,1280,7742,1.0,4,1280,0,98031
375000.0,3,2.5,1580,5725,2.0,3,1580,0,98072
420000.0,3,1.75,1660,9600,1.0,3,1380,280,98011
608000.0,4,2.5,2410,7140,2.0,3,2410,0,98074
620000.0,3,2.25,1720,4000,1.5,4,1450,270,98105
290000.0,3,2.0,1700,6498,1.0,3,1700,0,98038
319000.0,3,2.25,1220,2980,2.0,3,1220,0,98034
350000.0,3,2.5,2010,14298,2.0,3,2010,0,98070
454900.0,3,1.75,2130,9775,1.0,4,1430,700,98027
272000.0,4,2.25,1800,9018,2.0,3,1800,0,98022
280000.0,4,2.0,1600,6861,1.0,3,1600,0,98003
477000.0,4,1.5,1380,7800,1.0,3,1080,300,98125
595000.0,4,2.5,2100,3125,2.0,3,1400,700,98107
319000.0,3,1.75,1640,53400,1.0,4,1640,0,98070
225000.0,3,2.0,1320,5665,1.0,3,1320,0,98023
442250.0,3,2.5,2170,8169,2.0,3,2170,0,98059
276000.0,3,2.0,1450,8928,1.0,3,1450,0,98042
394000.0,3,2.5,1370,4400,1.0,3,1370,0,98034
260000.0,3,2.5,1420,14850,1.0,4,1020,400,98032
344950.0,3,2.0,1330,7419,1.0,3,1330,0,98034
230000.0,3,2.0,1310,7332,1.0,3,1310,0,98038
443500.0,4,2.5,2040,21781,2.0,3,2040,0,98014
471000.0,4,2.5,2040,21781,2.0,3,2040,0,98014
600000.0,4,1.75,1700,7800,1.0,4,1700,0,98052
427800.0,3,1.75,1340,13241,1.0,3,1340,0,98034
445000.0,4,2.0,1470,8395,1.0,4,1470,0,98008
382000.0,3,1.75,1790,7679,1.0,4,1790,0,98133
229950.0,3,2.0,1410,7466,1.0,3,1410,0,98058
753000.0,3,2.25,2290,9047,2.0,4,2290,0,98006
225000.0,3,1.75,1580,8820,1.0,4,1580,0,98003
431000.0,3,2.25,1830,8831,1.0,3,1460,370,98034
358500.0,3,2.5,2000,8057,1.0,3,1360,640,98042
295000.0,3,2.5,1560,4200,2.0,3,1560,0,98038
403900.0,4,2.5,2050,8909,1.0,4,1690,360,98198
269950.0,3,1.75,1760,12823,1.0,4,1460,300,98002
255000.0,3,1.75,1700,7532,1.0,3,1700,0,98030
270000.0,3,2.25,1500,7410,1.0,4,1500,0,98058
575000.0,4,1.75,1630,5750,1.0,3,1160,470,98116
245700.0,3,2.25,1640,8400,1.0,3,1180,460,98032
257000.0,3,1.75,1330,36537,1.0,4,1330,0,98092
415000.0,3,1.75,2000,8400,1.5,4,2000,0,98133
236000.0,3,1.75,1300,8976,1.0,3,1300,0,98003
780000.0,3,1.75,1690,13500,1.0,4,1690,0,98040
559500.0,4,1.75,1650,7088,1.0,3,1650,0,98027
671500.0,4,2.25,2130,8410,2.0,4,2130,0,98006
182000.0,3,2.25,1960,8875,1.0,3,1290,670,98003
740000.0,4,1.75,2010,3600,1.5,3,2010,0,98119
329950.0,3,2.5,1820,8085,2.0,3,1820,0,98055
448000.0,4,2.5,2230,5000,1.0,3,1650,580,98059
383000.0,4,2.5,2370,10580,2.0,3,2370,0,98055
490000.0,4,2.5,2242,37451,2.0,3,2242,0,98028
524950.0,3,1.5,2700,24539,2.0,3,2120,580,98019
729000.0,4,2.5,2450,27081,2.0,3,2450,0,98052
460000.0,3,1.75,1420,8250,1.0,4,1420,0,98007
687500.0,3,1.5,1280,2114,1.5,3,1280,0,98122
825000.0,4,2.25,2430,10050,2.0,4,2430,0,98006
470000.0,3,2.0,1800,12669,1.0,3,1800,0,98033
619500.0,4,2.5,2210,5077,1.5,4,1480,730,98126
477500.0,3,2.0,1860,5146,2.0,3,1860,0,98029
590000.0,4,2.5,2240,9385,2.0,3,2240,0,98133
205000.0,3,1.75,1170,8239,1.0,3,1170,0,98042
343500.0,4,1.75,1760,6204,1.0,4,1180,580,98178
370000.0,3,2.5,1780,4050,2.0,3,1780,0,98155
245000.0,3,1.75,1260,6908,1.0,3,1260,0,98038
490000.0,4,2.25,2020,4960,2.0,3,1710,310,98117
270000.0,4,2.5,1670,8056,1.0,3,1170,500,98168
240000.0,3,1.5,1460,13503,1.0,4,1460,0,98010
790000.0,3,1.75,1790,6117,1.0,3,1350,440,98199
350000.0,3,2.25,1760,9621,2.0,3,1760,0,98019
533000.0,4,2.5,2590,6394,2.0,3,2590,0,98028
875000.0,4,1.75,2180,9726,1.0,4,2180,0,98040
325000.0,4,2.75,2110,6838,2.0,4,2110,0,98031
334950.0,4,2.5,2410,7846,2.0,3,2410,0,98003
775000.0,3,2.5,1980,7807,2.0,4,1980,0,98033
565000.0,3,1.75,1720,2218,1.5,3,1270,450,98103
825000.0,3,2.25,2510,10418,1.0,3,1810,700,98115
525000.0,3,1.5,1540,4773,2.0,3,1540,0,98126
507000.0,3,2.25,1810,8158,1.0,3,1450,360,98074
275900.0,3,1.75,1380,8400,1.0,3,1380,0,98003
275000.0,4,1.75,1690,6000,1.0,3,1690,0,98178
650000.0,3,2.5,2320,5284,2.0,3,2320,0,98075
500000.0,3,1.75,1560,16194,1.0,3,1560,0,98005
443000.0,4,1.5,1860,12197,1.0,3,1860,0,98034
480000.0,4,1.75,1920,9380,1.0,3,1920,0,98008
299880.0,3,2.5,1460,3044,2.0,3,1460,0,98108
300000.0,4,2.5,2070,7476,2.0,3,2070,0,98092
525000.0,4,2.5,2140,7754,2.0,3,2140,0,98133
560000.0,3,2.5,2070,12708,2.0,3,2070,0,98056
394000.0,3,2.5,1680,4075,2.0,3,1680,0,98053
315000.0,3,2.5,1260,2767,2.0,3,1260,0,98059
590000.0,4,2.25,2430,32496,1.0,3,2430,0,98077
440500.0,3,2.5,1600,3172,2.0,3,1600,0,98053
273000.0,3,2.25,1830,7651,2.0,3,1830,0,98092
299900.0,3,2.25,2100,8163,2.0,3,2100,0,98001
281000.0,3,1.75,1690,9826,1.0,4,1690,0,98023
282000.0,4,2.0,1890,6302,2.0,3,1890,0,98030
745000.0,4,1.75,1990,8900,1.0,4,1990,0,98006
245000.0,3,1.75,1480,3900,1.0,4,1480,0,98023
250000.0,3,1.75,1480,3900,1.0,4,1480,0,98023
470000.0,3,2.5,2120,2374,2.0,3,1770,350,98052
590000.0,4,2.5,2010,7972,2.0,4,2010,0,98029
228900.0,4,1.5,1570,8775,1.0,3,1570,0,98166
660000.0,3,2.75,2210,4000,2.0,3,2210,0,98053
647000.0,4,2.5,2390,5800,2.0,3,2390,0,98075
366000.0,3,1.75,1520,8625,1.0,3,1520,0,98011
496700.0,3,2.5,1740,5782,2.0,4,1740,0,98029
300000.0,3,2.0,1550,8300,1.0,4,1550,0,98055
350000.0,3,2.25,1640,7200,2.0,4,1640,0,98007
561000.0,3,2.25,1640,7200,2.0,4,1640,0,98007
475000.0,3,1.75,1260,10065,1.0,3,1260,0,98006
290000.0,3,1.75,1590,13500,1.0,4,1090,500,98038
199000.0,3,2.5,1750,6725,1.0,3,1330,420,98038
279900.0,4,2.5,1770,4338,2.0,3,1770,0,98042
615000.0,4,2.25,2360,15860,1.0,3,2360,0,98074
451000.0,4,1.5,1620,5444,1.5,3,1620,0,98125
545800.0,4,2.5,1980,4500,2.0,3,1980,0,98029
195000.0,3,2.0,1230,8235,1.5,3,1230,0,98168
390000.0,4,2.0,2290,9200,1.5,3,2290,0,98166
339000.0,3,2.0,1979,8470,1.0,4,1329,650,98198
429900.0,4,1.5,1820,17918,1.0,4,1190,630,98056
370900.0,3,1.5,1200,8560,1.0,4,1200,0,98011
499000.0,4,2.5,1970,2601,2.0,3,1440,530,98144
580000.0,3,2.25,1670,7416,1.0,4,1220,450,98005
650000.0,4,2.0,1820,5000,1.5,3,1640,180,98115
398500.0,3,2.5,1630,1971,2.0,3,1630,0,98177
815000.0,3,2.0,2270,11989,1.0,4,2270,0,98040
760000.0,3,2.5,2050,15020,1.0,3,1600,450,98177
210000.0,3,2.5,1610,6732,2.0,3,1610,0,98030
349950.0,3,2.5,2140,7715,2.0,3,2140,0,98198
475000.0,4,1.75,2160,19283,2.0,3,2160,0,98011
650000.0,4,1.75,1900,10454,1.0,4,1180,720,98004
429950.0,3,1.5,2010,9480,1.0,3,1570,440,98125
677500.0,3,1.75,2020,9718,1.0,3,2020,0,98040
312000.0,4,2.25,1930,7452,1.0,3,1430,500,98031
675000.0,3,1.5,1460,6480,1.0,4,980,480,98117
491234.0,4,2.5,1540,1860,2.0,3,1540,0,98029
290000.0,3,2.0,1310,6265,1.0,3,1310,0,98038
299999.0,3,2.5,2380,9719,2.0,3,2380,0,98001
400000.0,3,2.75,2220,5000,2.0,3,2220,0,98108
357000.0,3,2.0,2460,53882,1.0,3,2460,0,98198
360000.0,4,2.5,2020,7289,2.0,3,2020,0,98031
240000.0,3,1.75,1240,10956,1.0,3,1240,0,98042
380000.0,3,1.75,1920,8775,1.0,3,1920,0,98166
315000.0,3,1.75,1410,15134,1.0,3,1410,0,98014
258950.0,3,1.75,1440,8050,1.0,3,1440,0,98023
400000.0,3,2.0,1760,6875,1.0,4,1760,0,98072
335000.0,3,1.75,2010,9417,1.0,4,1500,510,98030
185000.0,3,1.5,1280,4031,2.0,4,1280,0,98002
359900.0,4,2.5,2600,5188,2.0,3,2600,0,98038
560000.0,3,2.5,1960,6058,2.0,3,1960,0,98053
355000.0,3,1.75,1870,8250,2.0,3,1870,0,98188
402000.0,3,1.5,1320,3145,2.0,3,1320,0,98144
575000.0,4,1.5,1430,4163,1.5,3,1430,0,98199
216000.0,3,1.75,1580,9705,1.0,4,1580,0,98042
625000.0,4,1.75,2180,4431,1.5,3,2020,160,98112
820000.0,3,2.5,2510,5503,2.0,3,2510,0,98136
355000.0,3,2.5,1880,5290,1.0,3,1250,630,98108
495000.0,4,1.5,1810,7998,1.0,3,1210,600,98125
398750.0,3,2.5,2230,4000,2.0,3,2230,0,98144
625000.0,4,1.5,2120,5000,2.0,4,2120,0,98122
550000.0,4,2.5,2090,6926,2.0,3,2090,0,98074
311000.0,4,2.5,1975,8734,2.0,3,1975,0,98038
275000.0,4,1.5,1610,6923,1.0,3,1010,600,98198
373000.0,4,1.75,1590,7920,2.0,4,1590,0,98133
425000.0,3,1.5,1570,12412,1.0,3,1570,0,98166
472000.0,3,1.5,1740,9038,1.0,4,1740,0,98007
254000.0,3,2.0,1470,7694,1.0,4,1470,0,98038
900000.0,3,2.5,2260,9577,2.0,3,1700,560,98117
615000.0,4,2.5,2120,3720,2.0,3,2120,0,98029
550000.0,3,2.5,2080,7749,2.0,3,2080,0,98029
629000.0,4,2.25,1900,11171,1.0,3,1280,620,98006
665000.0,3,2.5,2610,35000,2.0,3,2610,0,98072
410000.0,3,2.25,1790,5794,1.5,3,1380,410,98072
650000.0,4,2.75,1910,16532,1.0,4,1420,490,98117
675000.0,4,1.75,1530,3615,1.5,4,1530,0,98103
300000.0,3,1.75,1730,6900,1.0,4,1130,600,98031
244000.0,3,2.5,1470,9337,2.0,3,1470,0,98155
597500.0,3,1.75,2030,32565,1.0,3,1600,430,98052
422500.0,4,2.5,2550,8824,2.0,3,2550,0,98031
410000.0,3,2.0,1270,10227,1.0,4,1270,0,98033
245000.0,3,2.0,1470,8000,1.0,4,1470,0,98023
455000.0,4,2.5,2440,5001,2.0,3,2440,0,98056
523000.0,3,1.5,1260,3135,1.5,3,1260,0,98116
250000.0,3,2.25,1640,4420,2.0,4,1640,0,98002
490000.0,3,2.25,2380,6000,1.0,3,2040,340,98115
402000.0,4,1.75,1640,10500,1.0,4,1010,630,98052
219950.0,3,1.5,1200,8404,1.0,3,1200,0,98188
319950.0,3,2.5,1700,7000,2.0,3,1700,0,98038
255000.0,3,2.5,1720,6194,2.0,3,1720,0,98092
465000.0,4,2.75,2190,3267,2.0,3,2190,0,98072
306000.0,3,1.75,1980,9800,1.0,3,1980,0,98030
617000.0,3,2.5,1880,5500,2.0,4,1880,0,98199
438750.0,3,1.75,1610,6480,1.0,4,1610,0,98125
303000.0,3,2.75,1850,8820,2.0,4,1850,0,98022
330000.0,3,1.75,1320,9675,1.5,4,1320,0,98024
700000.0,3,1.75,1990,13000,2.0,3,1990,0,98028
405000.0,3,2.0,1440,7425,1.0,4,1440,0,98034
485000.0,3,1.75,1790,6775,1.0,3,1790,0,98126
299950.0,3,2.5,1780,4650,2.0,3,1780,0,98038
585000.0,4,2.5,2200,9099,2.0,3,2200,0,98034
495000.0,4,2.0,1720,5413,2.0,3,1470,250,98115
447000.0,3,2.25,1520,14080,2.0,3,1520,0,98074
302500.0,4,2.5,1990,5511,2.0,3,1990,0,98030
250000.0,3,2.0,1440,5457,2.0,3,1440,0,98038
435000.0,4,2.5,2440,5350,2.0,3,2440,0,98059
590000.0,4,2.75,2240,5400,2.0,4,1540,700,98116
771000.0,4,2.5,2420,7200,2.0,3,2420,0,98033
325000.0,3,2.25,1570,43350,1.0,4,1570,0,98022
545000.0,4,1.75,1910,6731,1.0,4,1210,700,98116
232000.0,3,1.5,1460,15000,1.0,3,1460,0,98001
238000.0,3,1.5,1370,7439,1.0,4,1370,0,98055
260000.0,3,2.5,1500,7401,2.0,3,1500,0,98092
460000.0,3,1.75,1210,7500,1.0,3,1210,0,98027
265000.0,3,1.75,1450,5858,1.0,4,1450,0,98038
370000.0,3,1.5,1320,7201,1.0,3,1320,0,98034
256000.0,4,2.5,2050,5787,2.0,3,2050,0,98198
372000.0,4,2.5,2520,9604,2.0,3,2520,0,98031
312000.0,4,2.5,1790,10584,1.0,4,1290,500,98031
510000.0,3,2.0,1410,11995,1.0,4,1410,0,98006
740000.0,4,2.75,2890,4000,1.5,4,2190,700,98109
512000.0,4,2.5,2550,17209,2.0,3,2550,0,98059
491500.0,3,2.25,1470,4322,2.0,3,1470,0,98029
429950.0,4,1.75,1700,10230,1.0,3,1320,380,98133
364900.0,4,2.5,2490,9346,2.0,3,2490,0,98042
324950.0,3,1.5,1210,7560,1.0,3,1210,0,98126
250000.0,3,2.25,1620,10850,1.0,3,1620,0,98055
319950.0,3,2.5,2240,7500,2.0,3,2240,0,98092
419000.0,3,1.5,1500,8272,1.0,4,1500,0,98177
205000.0,3,2.0,1800,11419,1.0,3,1800,0,98092
335000.0,4,2.5,1980,4745,2.0,3,1980,0,98038
397000.0,3,1.75,1340,5100,1.0,3,1340,0,98103
330000.0,4,2.25,1790,9920,1.0,4,1170,620,98059
249900.0,3,2.0,1220,6404,1.0,3,1220,0,98038
717000.0,3,1.5,1310,3880,1.0,3,1090,220,98117
319000.0,4,2.5,1930,8336,2.0,3,1930,0,98031
305495.0,3,1.75,2110,10200,2.0,4,2110,0,98059
240000.0,4,2.0,1790,14690,1.0,4,1670,120,98198
255000.0,4,2.25,1680,3179,2.0,3,1680,0,98092
289000.0,4,2.25,1930,8925,1.0,4,1930,0,98058
746000.0,3,2.25,2370,9619,1.0,4,1650,720,98052
688100.0,4,2.5,2370,10513,2.0,4,2370,0,98052
870300.0,4,2.5,2350,3150,1.5,4,1690,660,98103
500000.0,3,2.5,2270,5654,2.0,3,2270,0,98133
255000.0,3,2.25,1830,7770,1.0,4,1400,430,98042
425000.0,3,2.25,1820,8058,1.0,3,1260,560,98034
700000.0,4,2.5,2440,7491,2.0,4,2440,0,98029
432000.0,3,2.0,1870,7080,1.0,4,1210,660,98034
530000.0,3,1.5,1240,4080,1.5,3,1240,0,98144
498688.0,3,2.5,1910,5600,2.0,3,1910,0,98029
349900.0,4,2.75,2530,13474,2.0,4,2530,0,98023
615000.0,4,1.5,1980,3240,1.5,4,1780,200,98144
332500.0,3,2.25,1800,10500,2.0,3,1800,0,98038
465000.0,4,1.75,1640,7194,1.5,4,1480,160,98011
339950.0,3,2.5,1730,4286,2.0,3,1730,0,98148
380000.0,4,2.5,2320,10079,2.0,3,2320,0,98038
440000.0,3,1.75,2030,17100,1.0,4,2030,0,98166
309500.0,3,1.5,1340,13560,1.0,3,1340,0,98028
567000.0,3,1.75,1630,4275,1.5,3,1630,0,98115
432000.0,4,1.75,1970,5160,1.5,3,1970,0,98126
294400.0,4,2.5,1788,10183,2.0,4,1788,0,98002
541900.0,3,2.5,1880,3054,2.0,3,1880,0,98007
255000.0,3,2.5,1610,6176,2.0,3,1610,0,98030
280500.0,3,1.5,1670,6988,1.0,3,1370,300,98148
354000.0,4,2.5,2580,5476,2.0,3,2580,0,98031
900000.0,3,1.75,1540,8400,1.5,3,1540,0,98122
419500.0,4,2.5,2550,7200,2.0,3,2550,0,98056
429950.0,4,2.5,2320,4524,2.0,3,2320,0,98059
464950.0,4,2.5,1640,6000,2.0,3,1640,0,98106
466800.0,3,2.5,1480,14250,2.0,3,1480,0,98033
374900.0,3,2.5,2480,4950,2.0,3,2480,0,98058
559500.0,3,2.25,2150,9250,2.0,3,2150,0,98052
522500.0,3,2.5,2370,7875,2.0,3,2370,0,98065
271920.0,3,2.0,1410,10248,1.0,3,1410,0,98001
485500.0,4,2.5,1800,4500,2.0,3,1800,0,98075
260250.0,3,1.75,1490,8357,1.0,4,1490,0,98038
250000.0,3,2.0,1680,7900,2.0,4,1680,0,98003
600000.0,4,2.0,2510,38141,1.0,3,2510,0,98034
571000.0,3,2.5,2510,5186,2.0,3,2510,0,98053
469500.0,3,2.25,1850,12000,1.0,4,1300,550,98072
785000.0,4,1.5,2220,4000,1.5,3,1970,250,98105
315000.0,4,2.5,1970,5190,2.0,3,1970,0,98059
509950.0,3,2.5,1880,4668,2.0,3,1880,0,98029
590000.0,3,2.5,1990,8325,2.0,4,1310,680,98034
239950.0,3,1.75,1670,6900,1.0,3,1170,500,98023
831000.0,4,2.5,2030,3905,1.5,4,1630,400,98103
750000.0,4,1.5,2030,3300,1.5,4,1530,500,98116
440000.0,3,2.5,2230,5800,2.0,3,2230,0,98065
319950.0,4,1.75,2310,8045,1.0,4,1650,660,98058
448500.0,3,2.25,1830,7943,2.0,3,1830,0,98028
365000.0,3,2.5,2470,7700,2.0,4,2470,0,98031
566000.0,3,2.25,1660,10140,1.0,4,1370,290,98052
185000.0,3,1.75,1500,7800,1.0,3,1500,0,98092
225000.0,4,1.5,1950,12559,1.5,3,1950,0,98188
389950.0,3,2.5,1700,6396,2.0,3,1700,0,98065
435000.0,3,2.5,2370,6082,2.0,3,2370,0,98065
845000.0,3,1.75,1600,2538,2.0,3,1600,0,98102
350000.0,3,2.25,1322,1796,2.0,3,1087,235,98144
395000.0,4,1.75,1950,10219,1.0,3,1950,0,98133
263000.0,3,2.25,1590,7748,2.0,4,1590,0,98003
247000.0,3,2.5,1510,10875,1.0,3,1150,360,98003
432500.0,3,2.5,2240,6396,2.0,3,2240,0,98065
540000.0,3,2.25,1320,1800,2.0,3,1320,0,98122
385000.0,3,1.75,1340,3850,1.0,4,1340,0,98125
240000.0,3,2.0,1220,17652,1.0,4,1220,0,98059
415500.0,3,2.0,1220,17652,1.0,4,1220,0,98059
257000.0,4,1.5,1400,8500,2.0,3,1400,0,98001
420000.0,3,2.5,2140,3821,2.0,3,2140,0,98029
513000.0,4,2.5,2000,5684,2.0,3,2000,0,98028
585000.0,3,1.75,1740,9500,1.0,4,1150,590,98146
215000.0,3,2.0,1290,9312,1.0,3,1290,0,98168
440000.0,4,2.0,1450,8400,1.5,4,1450,0,98034
270000.0,3,2.25,1420,7800,1.0,4,1130,290,98042
688500.0,3,1.75,1760,4125,1.5,4,1760,0,98103
655000.0,4,2.25,2420,7725,1.0,4,1890,530,98052
500000.0,4,2.5,1770,8155,1.5,4,1770,0,98034
280000.0,3,2.25,1360,9600,2.0,3,1360,0,98045
531000.0,3,2.5,2120,9736,2.0,3,2120,0,98011
617000.0,3,2.5,1910,4488,2.0,3,1910,0,98007
450000.0,3,2.25,1740,9488,1.0,4,1180,560,98056
699000.0,3,2.0,2010,4320,2.0,3,2010,0,98118
595000.0,4,2.5,2330,7064,1.0,4,1780,550,98052
285000.0,3,1.75,1930,7200,1.5,3,1930,0,98065
216300.0,3,2.5,1650,5000,2.0,3,1650,0,98023
210000.0,4,2.25,1500,5393,2.0,3,1500,0,98001
423000.0,4,1.75,1700,9000,1.0,3,1700,0,98034
325000.0,4,2.5,2240,5105,2.0,4,2240,0,98042
257000.0,3,1.75,1540,8223,1.0,4,1070,470,98042
505000.0,3,2.5,2340,5957,2.0,3,2340,0,98028
405000.0,3,1.5,1600,7500,1.0,3,1600,0,98034
427000.0,3,1.75,1300,5111,1.0,4,1300,0,98115
315000.0,3,2.5,2240,6097,2.0,3,2240,0,98038
371000.0,3,1.5,1420,4500,1.0,3,1420,0,98103
279900.0,3,1.75,1580,6620,1.0,3,1580,0,98003
506000.0,3,1.75,2180,7700,1.0,3,1480,700,98177
479000.0,4,2.5,2370,30378,2.0,3,2370,0,98042
306888.0,4,1.5,1940,8970,1.5,3,1270,670,98125
219950.0,3,1.5,1650,9936,1.0,3,1090,560,98003
471000.0,3,2.5,2030,2805,2.0,3,1720,310,98027
590000.0,3,2.0,1650,6150,2.0,4,1650,0,98116
305000.0,3,1.75,1660,11500,1.0,3,1130,530,98045
367400.0,4,1.5,1280,7400,1.0,3,1280,0,98008
700000.0,4,2.0,1930,5398,1.0,3,1430,500,98119
552775.0,3,2.5,1900,18414,2.0,3,1900,0,98074
601500.0,3,1.75,1460,10128,1.0,3,1460,0,98033
600000.0,3,1.75,1670,39639,1.0,4,1670,0,98075
310000.0,3,2.5,2370,6752,2.0,3,2370,0,98003
479900.0,3,2.0,1980,12150,1.0,3,1980,0,98042
400000.0,3,2.5,2080,7877,2.0,3,2080,0,98058
300000.0,3,2.5,1590,3381,2.0,3,1590,0,98019
437000.0,3,2.25,1980,8775,1.0,3,1290,690,98177
626000.0,4,1.75,1350,9293,1.0,4,1350,0,98004
490000.0,3,2.5,2080,12032,2.0,3,2080,0,98077
289000.0,3,2.5,2090,4700,2.0,3,2090,0,98042
595000.0,3,2.5,2030,5100,2.0,3,2030,0,98199
389000.0,3,1.75,1820,8028,1.0,3,1220,600,98133
240000.0,3,2.0,1300,5000,1.0,4,1300,0,98198
382500.0,4,2.5,2210,7079,2.0,3,2210,0,98031
511555.0,3,2.0,1400,7293,1.0,4,1400,0,98008
710500.0,3,1.75,2040,4125,1.5,4,1540,500,98107
429000.0,3,2.5,2420,49928,2.0,3,1860,560,98027
615000.0,3,1.75,2220,7224,1.0,3,2040,180,98177
242000.0,3,1.75,1300,9856,1.0,4,1300,0,98003
560000.0,3,2.5,1960,9686,1.0,3,1460,500,98074
260000.0,3,2.5,1520,6298,2.0,3,1520,0,98030
355000.0,3,2.0,1480,2502,2.0,3,1480,0,98103
545000.0,3,1.75,1810,3000,1.5,4,1810,0,98107
540000.0,3,1.75,1680,4240,1.5,4,1680,0,98144
615000.0,3,2.5,1910,3427,2.0,3,1910,0,98052
250000.0,4,2.0,2120,8701,1.5,4,2120,0,98198
310000.0,4,2.25,2192,12128,2.0,3,2192,0,98030
324500.0,3,2.5,1590,4108,2.0,3,1590,0,98056
385000.0,3,2.25,2110,8000,2.0,3,2110,0,98034
197400.0,3,2.0,1610,7575,1.0,4,1110,500,98003
267000.0,3,2.5,1760,6477,2.0,4,1760,0,98030
480000.0,3,1.5,1540,20281,1.0,3,1540,0,98075
640000.0,3,2.25,1980,10115,1.0,3,1980,0,98005
325000.0,3,2.0,1350,11805,1.0,3,1350,0,98019
465000.0,3,2.25,1920,7300,1.0,3,1240,680,98008
489950.0,3,2.25,1820,7326,2.0,3,1820,0,98034
365000.0,3,1.5,1310,8160,1.0,3,1310,0,98133
359950.0,3,2.0,1790,7212,1.0,4,1790,0,98042
495000.0,4,2.5,2460,4774,2.0,3,2460,0,98059
330000.0,3,1.75,1340,10276,1.0,4,1340,0,98034
450000.0,3,1.75,1480,8394,1.0,4,1480,0,98052
570000.0,4,2.5,2280,4534,2.0,3,2280,0,98075
480000.0,3,2.25,1950,8892,2.0,3,1950,0,98052
402200.0,3,1.75,1790,6980,1.0,3,1330,460,98034
481015.0,3,2.25,1550,5511,2.0,3,1550,0,98033
815000.0,3,1.5,1370,8671,1.0,3,1370,0,98004
550000.0,3,2.0,1650,3952,2.0,3,1650,0,98103
198000.0,3,1.75,1300,6318,1.0,3,1300,0,98001
741000.0,4,2.75,2070,10125,1.0,3,1390,680,98040
583000.0,3,1.5,1800,10050,1.0,3,1800,0,98008
349950.0,3,2.5,1700,7496,2.0,3,1700,0,98055
352500.0,3,1.75,1500,10269,1.0,3,1030,470,98133
259500.0,3,2.25,1490,7589,2.0,3,1490,0,98038
595000.0,4,2.5,1820,20011,2.0,3,1820,0,98075
325000.0,4,2.5,1830,7762,2.0,3,1830,0,98003
295000.0,4,2.0,1810,42981,1.0,4,1810,0,98024
749950.0,4,2.5,2370,2971,2.0,3,2080,290,98034
420000.0,3,2.25,2020,21010,2.0,3,2020,0,98014
339900.0,4,1.5,1570,9210,1.0,3,1400,170,98030
353000.0,4,2.5,1830,5331,2.0,3,1830,0,98038
675000.0,4,2.5,1770,9858,1.0,3,1770,0,98155
400000.0,3,2.5,2120,3757,2.0,3,2120,0,98059
450000.0,3,2.5,1670,2589,2.0,3,1670,0,98027
643002.0,3,2.5,1770,3744,1.5,3,1270,500,98117
324950.0,4,2.5,1770,5000,2.0,3,1770,0,98038
290000.0,3,2.0,1260,7346,1.0,3,1260,0,98031
488500.0,3,2.0,1710,10959,1.0,4,1030,680,98033
417000.0,3,2.75,1820,52889,2.0,3,1820,0,98070
380000.0,3,2.5,2390,8102,2.0,4,2390,0,98058
336500.0,4,2.5,2500,5264,2.0,3,2500,0,98038
670000.0,3,2.5,2050,6420,1.0,3,1730,320,98116
207000.0,3,1.75,1180,21275,1.0,4,1180,0,98038
615000.0,4,2.25,1780,10260,2.0,3,1780,0,98052
560000.0,3,2.0,1640,7333,1.0,4,1020,620,98108
359500.0,4,1.75,2030,7210,1.0,3,1450,580,98059
660000.0,3,2.5,2590,35640,1.0,3,2590,0,98029
258000.0,3,1.75,1620,7540,1.0,3,1310,310,98038
355000.0,3,1.75,2040,22693,1.0,4,2040,0,98042
628000.0,3,2.25,1720,8521,1.0,4,1140,580,98033
575000.0,4,2.0,1650,5000,1.0,3,1650,0,98117
680000.0,3,2.25,2300,9914,2.0,4,2300,0,98027
580000.0,3,1.5,1800,6250,1.0,3,1420,380,98116
263000.0,3,1.5,1300,7885,1.0,3,1300,0,98055
595000.0,3,2.5,2250,8300,2.0,3,2250,0,98125
485000.0,3,1.75,2030,10089,1.0,4,1330,700,98027
236000.0,4,2.75,2000,5827,2.0,3,2000,0,98038
630000.0,4,2.5,2540,8706,2.0,3,2540,0,98075
225000.0,3,2.5,1750,7490,1.0,4,1180,570,98042
610000.0,4,1.75,1830,29110,2.0,3,1230,600,98040
544000.0,4,2.5,2030,3974,2.0,3,2030,0,98029
540000.0,4,2.0,2190,8402,2.0,4,2190,0,98033
650000.0,4,2.5,2290,10186,2.0,3,2290,0,98008
502775.0,3,1.75,1700,9840,1.0,4,1200,500,98027
525000.0,4,2.75,2530,17856,2.0,3,2530,0,98019
433500.0,3,2.5,2200,3360,2.0,3,2200,0,98118
314950.0,4,1.75,1890,9623,1.0,4,1290,600,98001
500000.0,3,1.75,1530,14633,1.0,3,1100,430,98052
300000.0,3,1.5,1590,8911,1.0,3,1590,0,98028
275000.0,3,1.75,1300,8099,1.0,4,1080,220,98056
498000.0,3,1.5,1720,6570,1.5,4,1720,0,98118
297000.0,3,2.5,1840,8234,2.0,3,1840,0,98003
517000.0,3,2.25,1640,4635,1.5,3,1540,100,98115
230500.0,3,2.25,1690,7245,1.0,3,1160,530,98003
530000.0,3,1.75,1550,3680,1.0,3,1050,500,98117
475000.0,4,2.5,2320,10046,2.0,3,2320,0,98065
375950.0,3,1.75,1480,7560,1.0,3,1100,380,98117
311000.0,3,2.75,1400,7880,1.0,3,1000,400,98056
485000.0,3,2.5,1580,6065,2.0,3,1580,0,98029
485000.0,3,2.5,1800,11034,2.0,4,1800,0,98072
260000.0,3,2.25,1610,7423,2.0,4,1610,0,98042
356000.0,4,2.5,2470,5074,2.0,3,2470,0,98038
348450.0,4,2.5,1950,8628,2.0,3,1950,0,98038
535500.0,3,1.5,1730,40250,2.0,4,1730,0,98072
745000.0,3,1.75,1490,9800,1.0,4,1140,350,98004
355000.0,4,2.5,2040,8265,2.0,3,2040,0,98146
282000.0,3,2.5,1610,6000,2.0,4,1610,0,98038
432000.0,3,1.75,1550,8134,1.0,4,1550,0,98008
518000.0,3,1.75,1830,4500,1.5,4,1830,0,98115
575000.0,3,2.75,1990,9600,1.0,3,1530,460,98027
242025.0,4,1.75,1400,54014,1.5,4,1400,0,98031
440000.0,3,1.75,1450,6829,1.0,3,1450,0,98052
442500.0,3,1.5,2710,47419,1.5,3,2170,540,98053
381800.0,4,2.0,1530,5250,1.0,3,1110,420,98133
313000.0,3,1.75,2190,8000,1.0,4,2190,0,98023
618080.0,3,2.5,2030,6500,2.0,3,2030,0,98027
325000.0,3,2.25,2480,8755,2.0,3,2480,0,98058
583800.0,3,2.5,2480,6600,2.0,3,2480,0,98053
410000.0,4,2.0,1970,10500,1.0,3,1820,150,98166
640000.0,3,2.5,2370,11172,2.0,3,2370,0,98056
360000.0,3,1.75,1560,7930,2.0,4,1560,0,98059
313999.0,4,2.25,1870,4198,2.0,3,1870,0,98038
300000.0,3,2.25,2070,7225,1.0,3,1690,380,98042
227490.0,3,1.75,1820,7194,1.0,4,1820,0,98003
470950.0,3,2.5,2560,16420,2.0,4,2560,0,98014
735000.0,4,2.75,2450,4187,2.0,3,2450,0,98027
412000.0,3,2.5,2210,7000,2.0,4,2210,0,98058
670000.0,3,2.5,1800,4763,2.0,3,1240,560,98119
669888.0,4,2.75,2550,7591,2.0,3,2550,0,98059
405000.0,3,2.75,1310,7300,1.0,3,1310,0,98008
518000.0,3,1.5,1430,8000,1.0,4,1430,0,98007
435000.0,3,2.5,1600,2375,2.0,3,1600,0,98029
314950.0,3,2.0,1760,9732,1.0,3,1760,0,98022
630000.0,4,2.5,2330,31705,2.0,4,2330,0,98052
442000.0,4,1.5,1960,12688,1.5,4,1960,0,98052
230000.0,3,1.75,1400,6956,1.0,4,1400,0,98031
335000.0,3,2.0,1410,44866,1.0,4,1410,0,98023
379500.0,4,2.25,2120,53578,2.0,4,2120,0,98022
520000.0,3,2.0,1670,8800,1.0,4,1150,520,98008
515000.0,4,2.5,1800,4338,2.0,3,1800,0,98075
269900.0,3,2.25,1740,9672,1.0,4,1110,630,98031
458500.0,3,1.5,1280,1920,1.5,3,1280,0,98122
890000.0,4,2.0,1480,11171,1.5,4,1480,0,98075
361500.0,4,2.5,1980,7334,2.0,3,1980,0,98038
370000.0,3,2.5,2490,4244,2.0,3,2490,0,98042
676000.0,3,2.5,2240,3825,2.0,3,2240,0,98117
290000.0,3,1.75,1460,7980,1.0,3,1460,0,98028
261500.0,3,2.5,1740,6992,2.0,3,1740,0,98042
278000.0,4,2.5,2290,3777,2.0,3,2290,0,98198
355000.0,3,1.75,2040,8173,1.0,3,1470,570,98133
375000.0,4,1.5,1770,6650,1.0,3,1770,0,98008
680000.0,3,2.25,2270,23900,1.0,3,1820,450,98177
410000.0,3,1.75,1530,26642,1.0,3,1180,350,98072
562500.0,3,2.5,2030,7549,1.0,3,2030,0,98074
345000.0,4,2.5,2390,6976,2.0,3,2390,0,98056
335000.0,3,2.25,1870,5876,2.0,3,1870,0,98038
252000.0,3,2.0,1420,6788,2.0,3,1420,0,98023
705000.0,4,2.0,1820,5001,2.0,3,1820,0,98119
498000.0,3,2.0,1620,8400,1.0,3,1180,440,98052
209950.0,3,1.5,2290,9600,1.0,4,2290,0,98042
470000.0,4,2.0,2410,4680,2.0,3,2410,0,98008
258500.0,3,2.5,1800,9000,2.0,3,1800,0,98003
420000.0,3,1.75,1820,22320,1.0,3,1250,570,98053
252000.0,3,1.5,1400,6865,1.0,4,1400,0,98038
515000.0,3,2.5,2600,4506,2.0,3,2600,0,98028
575000.0,3,2.5,1760,2320,2.0,3,1760,0,98126
561500.0,4,2.25,2310,9800,1.0,3,1780,530,98033
475200.0,3,2.5,1670,3980,2.0,3,1670,0,98027
600000.0,4,2.5,2600,6536,2.0,3,2600,0,98056
545000.0,4,2.25,1890,7210,1.0,3,1890,0,98008
313100.0,3,2.0,1730,12821,1.0,3,1730,0,98001
345500.0,4,2.5,2160,9682,2.0,3,2160,0,98031
340000.0,3,2.5,2170,9798,2.0,3,2170,0,98038
642860.0,4,2.75,2520,6398,2.0,3,2520,0,98072
559950.0,4,2.5,2650,7200,2.0,3,2250,400,98133
287000.0,4,2.25,1980,7081,1.0,3,1470,510,98032
425000.0,4,2.5,2270,4400,2.0,3,2270,0,98065
695000.0,3,1.75,2080,5687,1.5,4,2080,0,98144
518000.0,4,1.75,1780,8768,1.0,4,1050,730,98125
515000.0,3,1.75,1490,12000,1.0,4,1490,0,98006
470000.0,3,1.5,1760,6723,1.0,3,1160,600,98118
606150.0,4,1.75,1770,9848,1.0,3,1370,400,98008
544950.0,3,1.75,1830,7371,1.0,3,1830,0,98008
382000.0,3,2.0,1360,4840,1.5,3,1360,0,98126
475000.0,3,1.75,1870,25157,2.0,3,1870,0,98014
355000.0,3,1.5,1370,4790,2.0,4,1370,0,98034
452500.0,4,2.5,2460,6454,2.0,3,2460,0,98065
245000.0,4,2.0,1580,8000,1.0,3,1040,540,98003
610000.0,4,2.5,2410,15899,2.0,3,2410,0,98074
510000.0,3,2.75,1950,12630,1.0,4,1230,720,98052
290000.0,4,2.5,2050,9015,2.0,4,2050,0,98058
316000.0,4,2.5,2320,7379,2.0,3,2320,0,98003
329900.0,3,2.0,1380,5198,1.0,4,1380,0,98106
229950.0,3,1.75,1170,11960,1.0,4,1170,0,98042
495000.0,3,1.75,1890,6557,1.0,3,1890,0,98125
726000.0,3,2.5,2040,10033,1.0,4,1420,620,98005
570000.0,4,2.5,2290,6738,2.0,3,2290,0,98029
320000.0,3,1.75,1510,30185,1.5,3,1510,0,98058
432000.0,3,2.5,1970,4036,2.0,4,1970,0,98065
335000.0,4,2.25,2400,8592,2.0,3,2400,0,98055
787500.0,4,1.75,1580,9382,1.0,3,1080,500,98039
535000.0,3,2.5,1970,6634,2.0,3,1970,0,98029
310000.0,3,2.5,1780,6771,1.0,3,1230,550,98106
242500.0,3,1.75,1550,1905,2.0,3,1550,0,98055
433200.0,3,2.5,2075,16200,2.0,3,2075,0,98045
323000.0,4,2.75,2000,9083,2.0,4,2000,0,98038
450000.0,4,1.75,1740,12204,1.0,3,1270,470,98155
542000.0,3,2.5,1990,15985,1.0,3,1540,450,98007
718000.0,3,2.5,2070,7200,2.0,3,2070,0,98033
305000.0,3,2.5,2030,8000,2.0,3,2030,0,98031
498000.0,3,2.5,1620,2640,2.0,4,1620,0,98122
737000.0,3,2.5,2300,7800,2.0,3,2300,0,98052
339950.0,3,2.5,2390,34041,1.0,3,1840,550,98042
725000.0,3,2.0,1550,12262,1.0,4,1550,0,98040
315000.0,4,2.25,1880,9163,2.0,3,1880,0,98058
350000.0,3,1.75,1970,10800,1.0,4,1300,670,98056
410000.0,3,2.25,1420,3750,2.0,3,1420,0,98116
430000.0,4,2.75,2290,5249,2.0,3,2290,0,98059
446000.0,4,2.5,1530,8375,1.0,3,1020,510,98034
385000.0,3,2.0,1590,9912,2.0,3,1590,0,98070
280000.0,3,2.5,1600,6700,2.0,3,1600,0,98042
399950.0,3,2.5,1510,7300,1.0,3,1040,470,98034
255000.0,3,1.5,1320,7980,1.0,3,1320,0,98178
575000.0,4,2.5,2040,5508,2.0,4,2040,0,98029
442573.0,3,1.75,1780,7567,1.0,3,1290,490,98034
485000.0,3,2.0,1610,4160,1.0,4,1010,600,98136
472500.0,4,1.75,1440,8536,1.0,4,1440,0,98033
398000.0,3,1.75,1890,16001,1.5,4,1890,0,98011
340000.0,3,2.5,2240,6000,2.0,3,2240,0,98059
400000.0,3,1.5,1330,9900,1.0,3,1330,0,98034
443950.0,3,1.75,2000,36000,1.0,3,2000,0,98056
302200.0,4,1.5,1730,10396,1.0,3,1730,0,98058
770000.0,3,2.5,2190,2658,2.0,4,2190,0,98033
374950.0,4,1.75,1660,8160,1.0,3,1660,0,98058
330000.0,3,2.5,2210,7557,2.0,3,2210,0,98023
536500.0,4,2.5,1720,3515,2.0,3,1470,250,98144
334009.0,4,2.0,1650,9305,1.0,4,1650,0,98034
350000.0,3,2.25,2010,4400,1.5,3,2010,0,98055
329932.0,3,1.5,1460,5040,1.0,3,1100,360,98133
539000.0,3,1.5,1460,5040,1.0,3,1100,360,98133
275000.0,3,1.75,1650,7700,1.0,4,1650,0,98023
575000.0,4,2.5,2120,9603,2.0,3,2120,0,98027
509000.0,3,2.25,1780,9315,2.0,3,1780,0,98133
555000.0,3,2.0,2180,4976,1.5,4,1680,500,98126
317000.0,3,2.0,1790,8228,1.0,3,1390,400,98058
430000.0,3,2.0,1910,5040,1.5,3,1910,0,98074
360000.0,4,2.5,2340,13445,2.0,3,2340,0,98042
372000.0,4,2.5,2070,8658,2.0,3,2070,0,98178
475000.0,4,2.5,2040,7260,2.0,4,2040,0,98133
310000.0,4,2.75,1950,9720,1.0,3,1400,550,98031
345000.0,3,2.5,1360,1489,2.0,3,1360,0,98126
436000.0,3,1.5,1500,10200,1.0,3,1300,200,98177
329950.0,4,2.25,2140,8874,2.0,3,2140,0,98092
395000.0,4,1.75,1910,8117,1.0,3,1460,450,98072
269000.0,3,2.25,1470,8682,1.0,3,1160,310,98003
345000.0,4,2.75,2200,13498,2.0,3,2200,0,98023
388500.0,3,2.25,1350,944,2.0,3,1050,300,98144
250000.0,3,1.75,1350,8548,1.0,3,1350,0,98003
455500.0,3,1.75,2290,19000,1.0,4,1650,640,98042
487000.0,3,1.75,1430,12632,1.0,3,1430,0,98008
291375.0,4,2.5,2220,6233,2.0,3,2220,0,98059
250000.0,3,2.5,2070,8400,2.0,4,2070,0,98002
599500.0,4,2.25,2020,10260,2.0,4,2020,0,98052
625000.0,4,1.5,2190,13660,1.0,3,2190,0,98177
525000.0,3,1.5,1840,10956,1.0,4,1840,0,98033
300000.0,3,2.5,2080,9827,2.0,3,2080,0,98023
545000.0,4,2.5,2500,50595,2.0,3,2500,0,98045
467100.0,3,1.75,1620,8645,1.0,3,1190,430,98052
749000.0,4,1.5,2130,5000,2.0,4,2130,0,98144
245000.0,3,2.5,1460,11593,2.0,3,1460,0,98023
565000.0,4,2.5,2280,4602,2.0,3,2280,0,98075
330000.0,4,2.25,2430,7490,2.0,3,2430,0,98058
725000.0,3,1.5,1790,6000,1.5,4,1790,0,98115
635000.0,3,1.75,1480,6985,1.5,4,1200,280,98117
330000.0,4,2.25,2440,8098,2.0,3,2440,0,98023
270000.0,3,2.5,1350,1189,2.0,3,1080,270,98106
340000.0,3,2.25,1970,3716,2.0,3,1970,0,98056
295000.0,4,2.0,1650,7200,1.0,3,1650,0,98133
460000.0,3,2.25,1620,7350,1.0,3,1170,450,98034
230000.0,3,1.5,1510,10588,1.5,3,1510,0,98198
360000.0,4,2.5,2000,5500,2.0,3,2000,0,98038
585000.0,3,2.5,2060,10839,2.0,3,2060,0,98029
182700.0,3,2.25,1740,6650,1.0,3,1240,500,98023
305000.0,3,2.25,1740,6650,1.0,3,1240,500,98023
309950.0,3,2.5,1880,7838,2.0,3,1880,0,98055
266950.0,3,2.5,1920,4803,2.0,3,1920,0,98042
633100.0,4,2.5,2470,33305,2.0,3,2470,0,98053
435000.0,3,2.25,1740,8491,1.0,3,1240,500,98177
435000.0,3,1.5,1740,6988,1.0,3,1600,140,98133
870000.0,4,1.75,1920,3600,2.0,4,1920,0,98119
532000.0,4,1.75,2020,7029,1.0,4,1430,590,98052
455000.0,4,1.5,1880,11400,1.0,3,1280,600,98177
475000.0,3,2.0,1230,11502,1.0,4,1230,0,98052
565000.0,4,1.5,2190,8296,2.0,3,2190,0,98136
375000.0,3,2.5,1670,7740,1.0,3,1130,540,98126
255000.0,3,1.5,1240,8528,1.0,4,1240,0,98058
496600.0,4,2.25,2020,8400,1.0,4,1350,670,98006
338950.0,3,1.75,1610,22496,1.0,4,1610,0,98042
549000.0,4,1.75,1290,3060,2.0,4,1290,0,98103
252000.0,3,2.25,1670,7881,1.0,4,1190,480,98031
270000.0,4,2.5,1660,8063,1.0,4,1660,0,98198
469000.0,4,2.5,2240,5624,1.0,3,1520,720,98108
531000.0,3,2.25,1910,8390,1.0,3,1910,0,98034
475580.0,3,1.75,1520,11085,1.0,3,1520,0,98074
599380.0,3,1.75,1270,7350,1.0,4,1270,0,98005
712000.0,4,2.25,2450,11960,1.0,3,2450,0,98074
365000.0,3,2.25,2290,7350,2.0,3,2290,0,98058
482500.0,3,2.5,1690,3068,2.0,3,1690,0,98053
390000.0,3,2.25,2270,32112,1.0,4,1740,530,98042
305000.0,3,2.0,1680,8487,1.0,3,1680,0,98022
453000.0,3,2.5,1650,1838,2.0,4,1270,380,98107
315000.0,3,2.0,1660,11135,1.0,3,1660,0,98045
445830.0,3,2.5,1870,5449,2.0,3,1870,0,98011
525000.0,4,1.5,1580,6360,1.5,3,1290,290,98115
549950.0,3,2.5,2080,8690,1.0,3,1430,650,98166
319950.0,3,2.5,1980,9907,2.0,3,1980,0,98022
381000.0,4,2.5,2130,6003,2.0,3,2130,0,98058
256900.0,3,2.5,1720,3951,2.0,3,1720,0,98031
545000.0,3,2.0,1900,9975,1.0,3,1500,400,98027
339950.0,4,2.25,2200,7150,2.0,4,2200,0,98042
555000.0,4,2.5,2450,5079,2.0,3,2450,0,98056
219000.0,4,1.5,1370,7944,1.5,3,1370,0,98198
570000.0,3,2.5,2420,11953,1.0,3,2420,0,98074
262500.0,4,2.75,1500,7036,1.0,3,1060,440,98032
260000.0,4,2.5,1990,6671,2.0,3,1990,0,98023
575000.0,4,2.5,2280,27441,2.0,3,2280,0,98072
385000.0,3,2.25,1650,7800,1.0,3,1260,390,98011
637000.0,4,2.5,1710,5000,1.0,3,1110,600,98115
548000.0,3,2.5,2110,4099,2.0,3,2110,0,98072
379880.0,3,2.5,1650,14054,1.0,4,1130,520,98027
530000.0,3,2.5,1950,9906,2.0,3,1950,0,98074
425000.0,3,2.25,1790,10209,1.0,3,1290,500,98072
490000.0,3,2.5,1930,7266,2.0,3,1930,0,98125
540000.0,4,2.5,2050,3784,2.0,3,2050,0,98034
667500.0,3,1.75,2130,20423,1.0,3,2130,0,98004
225000.0,3,1.5,1390,12500,1.0,4,1390,0,98014
335000.0,3,2.0,1490,8847,1.0,4,1490,0,98177
420000.0,3,1.75,1720,5000,1.5,3,1720,0,98019
279500.0,3,1.5,1200,8040,1.0,4,1200,0,98146
380000.0,4,2.25,1860,7980,1.0,4,1860,0,98058
245000.0,4,2.25,2050,7700,2.0,3,2050,0,98023
658500.0,4,2.25,1900,5000,1.0,3,1400,500,98199
595000.0,4,2.5,1990,2175,2.0,3,1680,310,98107
635000.0,4,2.25,2350,46173,2.0,4,2350,0,98053
395000.0,3,2.5,2300,8938,2.0,3,2300,0,98031
265000.0,3,2.5,1780,6527,2.0,3,1780,0,98092
625000.0,4,2.25,2470,17008,2.0,4,2470,0,98075
370000.0,4,2.75,2420,39704,1.0,3,2420,0,98038
683500.0,3,1.5,1820,5756,1.5,3,1640,180,98119
499950.0,3,2.5,1520,2208,2.0,3,1040,480,98119
279000.0,3,2.5,1920,7779,2.0,3,1920,0,98031
602000.0,3,2.5,1640,3804,2.0,3,1640,0,98122
492000.0,4,2.0,1640,5000,2.0,3,1640,0,98107
293500.0,3,2.5,1610,5024,2.0,3,1610,0,98038
375000.0,3,1.75,2140,13598,1.5,4,1620,520,98014
760000.0,3,2.0,1780,1750,1.0,3,1400,380,98103
260000.0,3,2.5,1850,7875,1.0,3,1250,600,98058
466200.0,3,1.5,1340,8856,1.0,4,1340,0,98008
450000.0,3,2.0,1610,4364,2.0,3,1610,0,98029
185000.0,3,1.5,1200,1848,2.0,3,1200,0,98055
545000.0,3,2.5,2180,15693,1.0,4,1850,330,98075
609950.0,3,2.25,1760,10350,1.0,4,1330,430,98033
550000.0,4,2.5,2120,9163,1.0,4,1450,670,98006
384200.0,3,2.5,2430,7613,2.0,4,2430,0,98058
270000.0,3,2.5,1808,19200,1.0,3,1808,0,98001
510000.0,3,1.75,1950,8325,1.0,4,1950,0,98011
337500.0,3,1.75,1350,5850,1.0,4,1050,300,98198
312000.0,3,2.25,1470,7857,1.0,4,1180,290,98055
265000.0,3,2.25,1840,6750,1.0,4,1270,570,98031
271000.0,4,1.75,1490,9112,1.0,3,970,520,98146
395000.0,4,2.0,2240,7085,1.5,3,2240,0,98125
340000.0,3,2.0,1460,5715,1.0,3,1460,0,98118
667000.0,3,1.75,1770,3880,1.0,3,1300,470,98117
417000.0,3,2.5,2040,11211,2.0,3,2040,0,98055
451000.0,4,1.75,1260,7250,1.0,3,1260,0,98027
570000.0,4,2.25,2380,36446,2.0,4,2380,0,98077
275000.0,3,2.0,1340,9764,1.0,3,1340,0,98052
739888.0,3,2.5,2420,43177,2.0,4,1690,730,98075
452500.0,3,2.5,2240,7791,2.0,3,2240,0,98065
280000.0,4,2.5,2200,5893,2.0,3,2200,0,98042
529950.0,3,2.0,1540,8400,1.0,3,1180,360,98052
462608.0,3,2.5,2010,2778,2.0,3,1390,620,98029
510000.0,3,2.5,1890,5929,2.0,3,1890,0,98029
280000.0,3,2.25,1810,7630,1.0,4,1810,0,98056
375000.0,3,2.25,1330,8004,2.0,3,1330,0,98034
336000.0,4,2.25,2210,11700,2.0,4,2210,0,98032
235000.0,3,1.75,1520,12246,1.0,4,1520,0,98010
530000.0,4,2.25,2130,8640,1.0,3,1430,700,98034
690000.0,3,2.5,2590,4961,2.0,3,2590,0,98126
530000.0,3,2.75,2100,20150,1.0,4,2100,0,98034
535000.0,3,2.5,2400,12546,1.0,3,2400,0,98074
600000.0,3,1.75,1580,7416,1.0,3,1150,430,98005
271675.0,3,1.75,2140,13068,1.0,4,1460,680,98092
810000.0,4,2.75,2820,5000,1.5,3,2170,650,98199
331292.0,3,1.75,1660,10000,1.0,3,1660,0,98019
530000.0,3,2.5,2160,9063,2.0,3,2160,0,98133
227000.0,3,1.75,1510,9837,2.0,3,1510,0,98001
285000.0,3,1.5,1870,42070,1.0,3,1870,0,98168
366000.0,3,2.0,1350,10200,1.0,3,1350,0,98074
185000.0,3,1.75,1170,9085,1.0,3,1170,0,98023
240000.0,4,2.25,1830,7614,2.0,3,1830,0,98030
461000.0,3,2.5,1690,3026,2.0,3,1690,0,98053
452000.0,3,2.5,1690,4000,2.0,3,1690,0,98053
538000.0,4,1.75,1880,7953,1.0,4,1880,0,98008
276000.0,3,2.0,1370,8137,1.0,4,1370,0,98003
352500.0,3,1.5,1360,7680,1.0,3,1360,0,98133
629500.0,3,2.0,2020,10584,1.0,3,2020,0,98075
275000.0,3,1.5,1320,7695,1.0,4,1320,0,98056
450000.0,3,2.25,1940,8312,1.0,4,1220,720,98166
294000.0,3,2.25,1700,9600,2.0,3,1700,0,98042
480000.0,3,1.75,1960,43995,1.0,3,1960,0,98059
720000.0,3,2.25,2120,9297,2.0,4,2120,0,98006
536000.0,3,2.75,2290,34548,2.0,4,2290,0,98042
324900.0,4,2.5,1880,7965,2.0,3,1880,0,98038
292500.0,3,2.25,1690,7320,2.0,3,1690,0,98198
860000.0,4,1.75,1880,3720,1.5,4,1880,0,98109
495000.0,4,2.5,2140,7245,2.0,3,2140,0,98133
320000.0,4,2.5,2000,10051,2.0,3,2000,0,98038
444000.0,3,2.0,1460,2610,2.0,3,1460,0,98103
432000.0,3,2.5,1660,15000,1.0,4,1660,0,98075
611000.0,4,2.5,2460,4200,2.0,3,2460,0,98074
565000.0,3,2.0,2290,9450,1.0,3,1670,620,98008
630000.0,4,2.5,2290,26720,2.0,3,2290,0,98177
594000.0,3,2.25,1270,1406,2.0,3,1060,210,98105
485000.0,4,1.75,1430,4096,2.0,3,1430,0,98122
470000.0,3,1.75,1310,8600,1.0,4,1310,0,98033
295500.0,3,1.75,1590,41550,1.5,3,1290,300,98168
200000.0,4,2.5,1720,8638,2.0,3,1720,0,98003
434900.0,3,2.0,1520,11067,1.0,3,1140,380,98074
565000.0,4,1.75,2030,7350,1.0,3,2030,0,98008
289950.0,3,2.5,1870,1436,2.0,3,1870,0,98059
372000.0,3,2.5,1710,5633,2.0,3,1710,0,98034
207000.0,4,2.0,1690,7728,1.5,4,1690,0,98198
780000.0,3,1.75,2340,10495,1.0,4,2340,0,98040
400000.0,4,1.75,1700,20283,1.5,3,1340,360,98019
440250.0,3,1.5,1850,8124,1.0,4,1850,0,98177
551000.0,4,2.75,2170,5988,2.0,3,2170,0,98155
850000.0,3,2.5,2340,1919,2.0,4,2340,0,98033
432500.0,3,2.5,1340,8867,2.0,3,1340,0,98125
229999.0,4,2.0,1670,5200,1.0,4,1030,640,98042
334000.0,4,1.5,1680,7620,1.0,4,1180,500,98166
249900.0,3,2.5,1630,7700,1.0,3,1120,510,98031
310000.0,4,1.75,1480,11200,1.0,4,1480,0,98059
420000.0,4,2.5,1940,5414,2.0,3,1940,0,98108
528000.0,3,2.5,2020,5613,2.0,3,2020,0,98053
530000.0,3,2.5,2480,7480,2.0,3,2480,0,98072
334500.0,3,2.0,1700,8160,1.0,3,1120,580,98133
311000.0,3,2.0,1190,7840,1.5,4,1190,0,98108
260000.0,3,2.75,1730,4131,2.0,3,1480,250,98106
217500.0,3,1.75,1400,9546,1.0,4,1400,0,98003
290000.0,3,2.5,2200,4240,2.0,3,2200,0,98042
423500.0,3,2.0,1770,6000,1.0,3,1100,670,98118
299000.0,3,2.5,1590,3121,2.0,3,1590,0,98118
289950.0,3,2.5,1960,3480,2.0,3,1960,0,98056
280000.0,3,1.75,1360,6603,1.0,4,1360,0,98058
304400.0,4,2.75,2140,8100,2.0,4,2140,0,98023
580000.0,3,1.75,1950,10633,1.0,3,1250,700,98125
274000.0,3,1.75,1440,7198,1.0,3,990,450,98055
315000.0,3,2.25,1530,7906,1.0,3,1150,380,98058
502000.0,3,2.25,1600,45613,2.0,4,1600,0,98072
260000.0,3,1.75,1750,11180,1.0,3,1750,0,98059
230000.0,3,1.5,1900,9630,1.0,3,1900,0,98023
364000.0,4,2.5,2080,11050,1.0,4,2080,0,98059
585000.0,3,1.5,1670,5000,1.5,4,1670,0,98117
801501.0,4,2.25,2250,13500,2.0,4,2250,0,98007
447500.0,3,1.75,1950,6504,1.0,3,1530,420,98115
310000.0,4,2.5,2440,7093,2.0,3,2440,0,98030
210000.0,3,1.5,1400,9600,1.0,4,1400,0,98003
384205.0,3,2.75,1810,3292,2.0,3,1810,0,98065
427500.0,4,2.5,2010,6294,2.0,3,2010,0,98028
339950.0,4,2.5,2150,4000,2.0,3,2150,0,98038
240000.0,4,1.5,1780,14810,1.0,4,1180,600,98032
255000.0,3,2.0,1310,8454,1.0,3,1310,0,98042
353500.0,4,2.5,1770,9239,2.0,3,1770,0,98038
563500.0,4,2.5,2190,4944,2.0,3,2190,0,98065
469900.0,3,2.5,2270,4399,2.0,3,2270,0,98065
495000.0,3,2.0,1769,9300,1.0,4,1769,0,98166
327000.0,4,2.5,1630,5361,2.0,3,1630,0,98144
300000.0,4,2.5,2600,8572,2.0,3,2600,0,98001
418500.0,3,2.0,1800,12440,1.0,3,1220,580,98074
450000.0,4,2.5,2240,4616,2.0,3,1840,400,98056
267500.0,3,2.25,1860,12000,1.0,4,1860,0,98092
479500.0,3,2.75,2300,4637,2.0,3,2300,0,98065
265000.0,3,1.75,1170,8148,1.0,3,1170,0,98155
399000.0,3,1.75,1170,8148,1.0,3,1170,0,98155
360000.0,4,2.5,2570,4557,2.0,3,2570,0,98042
655000.0,3,2.5,2370,7916,2.0,3,2370,0,98056
449950.0,4,1.5,1800,10150,1.5,4,1800,0,98034
338000.0,3,1.75,1250,7710,1.0,4,1250,0,98155
295000.0,4,2.5,1677,7209,2.0,3,1677,0,98023
265000.0,3,2.5,1410,2500,2.0,3,1410,0,98146
362764.0,3,2.0,1460,4350,2.0,3,1460,0,98053
427000.0,4,2.5,1600,14000,1.0,3,1310,290,98125
405000.0,3,1.75,2020,8531,1.0,3,2020,0,98011
246500.0,3,1.5,1170,11530,1.0,3,1170,0,98198
240000.0,3,1.75,1770,8571,1.0,3,1270,500,98023
249000.0,3,1.75,1300,8500,1.0,4,1300,0,98022
333000.0,4,2.5,2100,7366,2.0,3,2100,0,98042
670000.0,4,2.25,2370,9636,1.0,3,1660,710,98033
247200.0,3,1.5,1910,10583,1.5,4,1910,0,98002
440000.0,3,1.75,1430,8400,1.0,4,1430,0,98008
700000.0,4,2.5,2490,7694,2.0,3,2490,0,98029
756100.0,4,2.0,2000,8317,1.5,4,2000,0,98126
220000.0,4,1.75,1530,18400,1.5,4,1530,0,98002
650000.0,4,2.75,2020,15810,1.0,4,1620,400,98005
410000.0,3,1.75,1340,9975,1.0,4,1340,0,98033
339995.0,4,2.5,2180,5367,2.0,3,2180,0,98038
766000.0,3,2.5,2270,9822,2.0,3,2270,0,98052
231500.0,3,2.25,1630,7900,1.0,4,1130,500,98023
338900.0,3,1.75,1180,4000,1.0,3,1040,140,98118
252000.0,3,1.75,2050,11313,1.0,3,1520,530,98023
270000.0,3,2.5,1430,8470,1.0,3,1190,240,98022
325000.0,3,2.5,2260,8120,2.0,3,2260,0,98023
400000.0,4,1.75,1580,5340,1.0,3,1130,450,98144
580000.0,3,2.25,1580,8506,2.0,3,1580,0,98033
491300.0,3,1.75,1750,11340,1.0,4,1300,450,98074
272000.0,4,2.75,1810,7350,1.0,4,1200,610,98030
464000.0,3,2.5,1770,5146,2.0,3,1770,0,98029
230000.0,3,1.5,1500,11616,1.0,3,1100,400,98031
542000.0,4,2.5,2020,3440,1.5,4,1480,540,98117
625000.0,4,2.25,2660,22194,1.0,4,2180,480,98008
263850.0,4,2.25,2300,7524,2.0,4,2300,0,98023
325000.0,4,2.5,2280,9899,2.0,3,2280,0,98058
364000.0,3,2.25,1420,6600,1.0,3,1160,260,98028
402500.0,3,2.25,2160,9540,2.0,3,2160,0,98028
375000.0,3,1.75,2100,9066,1.0,3,1440,660,98188
402000.0,3,1.5,1450,7375,1.0,3,1010,440,98034
345000.0,3,1.75,1380,10529,1.0,3,1380,0,98034
218500.0,4,1.75,1400,25500,1.0,4,1400,0,98042
695000.0,3,2.5,2550,45254,2.0,3,2550,0,98053
480000.0,3,1.75,1710,4080,1.0,4,1130,580,98136
320000.0,3,2.5,1680,4584,2.0,3,1680,0,98056
640000.0,3,2.5,2390,8315,2.0,4,2390,0,98074
300000.0,4,2.25,1660,3200,2.0,3,1660,0,98038
418000.0,3,2.0,1410,6030,1.5,4,1410,0,98103
384000.0,3,2.5,1700,4000,2.0,3,1700,0,98065
325000.0,3,2.5,2070,8337,2.0,3,2070,0,98030
600000.0,3,1.75,2300,12682,1.0,3,2300,0,98028
447500.0,3,2.5,2320,15024,2.0,3,2320,0,98045
339100.0,4,2.5,2350,10655,2.0,3,2350,0,98092
515000.0,3,1.75,1300,5120,1.5,4,1300,0,98116
245000.0,3,1.5,1330,7125,2.0,3,1330,0,98034
690000.0,3,2.75,2480,3240,1.5,3,1890,590,98112
280000.0,3,1.75,1770,8240,1.0,4,1240,530,98023
285000.0,3,1.75,1930,6533,1.0,3,1230,700,98055
320000.0,3,2.25,1650,7047,2.0,3,1650,0,98038
670000.0,3,2.0,2570,10078,1.5,3,2570,0,98008
345000.0,3,2.75,2190,7258,2.0,3,2190,0,98003
295000.0,4,2.25,1830,5720,2.0,3,1830,0,98030
380000.0,3,2.5,1880,6047,2.0,3,1880,0,98038
898000.0,3,2.25,2580,11060,1.0,3,2580,0,98005
365000.0,3,2.5,2190,5091,2.0,3,2190,0,98038
318000.0,4,2.25,2180,7000,1.0,3,1680,500,98055
284000.0,3,2.25,2080,2050,1.5,3,1550,530,98042
620000.0,3,2.0,2460,41343,1.0,4,2460,0,98027
306000.0,3,2.5,2588,5702,2.0,3,2588,0,98042
495000.0,4,1.75,2570,12039,1.0,3,1910,660,98074
499950.0,3,2.5,2370,12753,2.0,3,2370,0,98019
599950.0,4,2.5,2290,6318,2.0,4,2290,0,98029
360000.0,4,2.5,2050,9143,2.0,3,2050,0,98166
374500.0,3,2.25,1400,11400,2.0,3,1400,0,98028
467000.0,3,2.5,1990,4978,2.0,3,1990,0,98065
593000.0,3,2.75,1830,1850,2.0,3,1690,140,98027
593777.0,3,1.75,1510,10450,1.0,4,1510,0,98052
550000.0,3,2.5,2080,2625,2.0,3,2080,0,98029
230000.0,3,1.75,1520,15344,1.0,3,1520,0,98023
712500.0,3,1.75,1770,2800,1.5,3,1770,0,98103
480000.0,3,2.5,2200,4692,2.0,3,2200,0,98011
470000.0,3,2.5,2000,8424,1.0,4,1300,700,98034
335000.0,3,1.75,1730,15003,1.0,3,1150,580,98014
197000.0,4,2.25,1790,13200,1.0,3,1220,570,98058
460000.0,3,2.25,1530,1840,2.0,3,1240,290,98144
240000.0,3,2.0,1460,7526,1.0,3,1460,0,98003
383000.0,3,1.75,1410,7215,1.0,3,1410,0,98034
750000.0,4,2.75,1750,5080,1.5,3,1750,0,98122
246000.0,3,1.5,1780,23819,1.0,3,1780,0,98168
339950.0,3,2.25,1630,12295,2.0,4,1630,0,98058
698000.0,3,2.5,2580,4636,2.0,3,2580,0,98074
425000.0,3,2.5,1960,4709,2.0,3,1960,0,98065
350000.0,4,2.25,2190,3850,2.0,3,2190,0,98059
790000.0,4,1.75,1820,6137,1.5,4,1690,130,98107
834000.0,3,2.25,2550,4089,2.0,3,2550,0,98112
420000.0,3,2.5,1770,3993,2.0,3,1770,0,98074
549000.0,3,2.25,1920,10961,2.0,3,1920,0,98074
485000.0,3,2.5,1680,7385,2.0,3,1680,0,98074
280000.0,3,1.75,1590,27200,1.5,4,1590,0,98038
649000.0,3,2.0,1810,17006,2.0,3,1810,0,98166
625000.0,4,2.75,2390,6979,2.0,3,2390,0,98029
600000.0,4,2.5,2070,8127,1.5,3,1590,480,98125
395000.0,4,2.0,1780,8149,1.5,4,1780,0,98155
212000.0,4,2.5,1900,21780,1.5,3,1900,0,98198
870000.0,4,1.75,2370,5000,1.5,3,1770,600,98103
420000.0,3,2.5,1970,3667,2.0,3,1970,0,98065
800000.0,4,2.25,2120,9921,2.0,3,2120,0,98027
575000.0,3,2.5,1960,9535,2.0,3,1960,0,98011
400000.0,3,2.25,1180,14258,2.0,3,1180,0,98034
379000.0,3,2.5,1530,2913,2.0,4,1530,0,98033
626000.0,3,1.75,2430,5000,2.0,4,1760,670,98117
575000.0,3,2.5,2070,3599,2.0,3,2070,0,98033
399950.0,3,1.75,2450,15001,1.0,3,1980,470,98014
405000.0,4,2.25,1970,15743,1.0,3,1370,600,98011
340000.0,3,1.75,1270,8422,1.0,3,1270,0,98011
214950.0,3,1.75,1570,4875,1.0,4,1310,260,98042
681000.0,3,1.75,1880,10032,1.0,4,1880,0,98006
380000.0,3,2.0,1660,8281,1.0,3,1660,0,98136
315000.0,3,2.5,1950,9618,2.0,3,1950,0,98031
449950.0,4,2.5,2470,3811,2.0,3,2470,0,98065
389000.0,3,1.75,1400,10018,1.0,4,1400,0,98027
360000.0,4,2.5,2490,4751,2.0,3,2490,0,98056
550000.0,4,2.25,1650,7200,1.0,3,1650,0,98008
257500.0,3,1.5,1210,12500,1.0,3,1210,0,98146
455000.0,4,1.75,1790,45738,1.0,3,1410,380,98072
639900.0,3,2.5,2330,4160,2.0,4,2330,0,98052
661000.0,3,2.0,1820,4418,2.0,4,1820,0,98033
365000.0,3,2.25,2430,7614,1.5,3,1900,530,98056
410000.0,3,1.5,1750,32500,1.0,4,1750,0,98027
397950.0,4,1.75,2120,7620,2.0,3,2120,0,98166
201000.0,4,1.5,1360,8100,1.5,3,1360,0,98168
300000.0,3,1.5,1810,8232,1.0,3,1810,0,98001
374950.0,3,2.5,2120,9653,2.0,3,2120,0,98030
602500.0,4,1.75,2190,41000,2.0,3,2190,0,98075
235000.0,4,2.0,1540,9279,1.0,3,1540,0,98118
599000.0,4,2.5,2120,3640,2.0,3,2120,0,98029
562100.0,3,2.25,2090,12112,2.0,3,2090,0,98052
640000.0,3,2.5,1620,1377,2.0,3,1100,520,98112
294000.0,3,2.0,1650,11256,1.0,4,1250,400,98168
280000.0,4,2.25,1600,7916,2.0,3,1600,0,98022
260000.0,4,2.5,1790,4358,2.0,3,1790,0,98031
294000.0,3,1.5,2060,15050,1.5,4,2060,0,98023
450000.0,3,2.0,1510,43560,1.0,3,1510,0,98077
335000.0,3,2.25,1580,16215,1.0,4,1580,0,98024
270000.0,4,1.5,1730,8505,1.5,4,1730,0,98146
493000.0,4,1.75,2030,18295,1.5,4,2030,0,98034
740000.0,4,2.5,2500,10330,2.0,3,2500,0,98006
789800.0,3,2.5,2605,2216,2.0,3,2090,515,98033
521900.0,3,2.5,2100,12338,2.0,3,2100,0,98072
442500.0,3,1.75,1800,10200,1.0,3,1800,0,98058
274950.0,3,2.0,1410,7265,1.0,4,1410,0,98042
407185.0,3,1.75,1860,48076,1.5,4,1860,0,98070
675000.0,3,1.75,2130,4400,1.0,3,1430,700,98102
412950.0,4,2.5,2430,6796,2.0,3,2430,0,98058
420000.0,3,1.75,1230,10005,1.0,4,1230,0,98008
680000.0,3,2.5,2120,3600,2.0,3,2120,0,98052
875000.0,3,2.5,1820,6848,1.0,4,1820,0,98004
426000.0,3,2.5,2210,5750,2.0,3,1710,500,98106
810000.0,3,1.75,2060,3300,2.0,4,1500,560,98102
459000.0,3,2.5,1780,4000,2.0,4,1780,0,98029
260000.0,3,1.75,1460,10000,1.0,4,1460,0,98092
290000.0,3,1.75,1390,13200,2.0,3,1390,0,98045
690000.0,4,2.0,2230,5000,1.5,4,1510,720,98144
825000.0,4,2.25,2110,12653,2.0,4,2110,0,98040
664000.0,4,2.5,2390,8432,2.0,3,2390,0,98074
662500.0,3,2.0,2070,4200,1.5,4,1670,400,98103
450000.0,3,1.5,1440,9711,1.0,3,1140,300,98028
538250.0,3,2.25,2590,15229,2.0,3,2590,0,98198
433000.0,3,1.75,1870,7189,1.0,3,1270,600,98118
212000.0,3,2.25,1900,18000,1.0,4,1280,620,98023
279000.0,3,2.0,1640,5650,1.0,3,1640,0,98042
619000.0,4,1.75,1660,3800,1.5,3,1660,0,98115
275000.0,3,2.25,1640,6044,2.0,3,1640,0,98002
460000.0,3,2.25,1650,7313,1.0,3,1220,430,98011
286000.0,3,2.5,1800,3980,2.0,3,1800,0,98042
385000.0,4,1.75,1970,10358,1.0,3,1540,430,98028
822000.0,3,2.5,2290,9158,2.0,4,2290,0,98006
473600.0,4,1.5,1780,8400,1.0,3,1080,700,98136
418000.0,3,1.75,1500,19113,1.0,3,1500,0,98014
280000.0,3,2.5,1580,7000,2.0,3,1580,0,98030
756000.0,3,2.5,2160,7525,2.0,3,2160,0,98052
350000.0,3,2.25,1410,1340,2.0,3,1370,40,98008
320000.0,3,1.5,1400,9087,1.0,3,1400,0,98133
234000.0,4,2.0,1710,7455,1.0,3,1030,680,98031
517500.0,4,2.5,1520,3370,2.0,3,1520,0,98029
749500.0,4,2.5,2440,9727,2.0,3,2440,0,98052
815000.0,4,1.75,1820,4500,1.5,3,1820,0,98119
175000.0,3,1.5,1220,7300,1.0,3,1220,0,98001
429950.0,3,1.75,1830,9758,1.0,3,1300,530,98034
580000.0,3,2.25,1940,5980,1.0,3,1520,420,98027
240000.0,4,2.0,1750,7800,1.0,4,1750,0,98166
374000.0,3,2.5,1850,17808,1.0,4,1210,640,98032
275000.0,3,1.75,1290,9760,1.0,3,1290,0,98058
489900.0,4,2.5,2090,4196,2.0,3,2090,0,98011
545000.0,3,2.5,1900,3366,2.0,3,1900,0,98033
655000.0,4,2.25,2170,4080,2.0,3,1920,250,98122
572000.0,3,2.25,1830,7897,1.0,4,1290,540,98052
375000.0,3,2.5,1520,5649,2.0,4,1520,0,98034
295000.0,3,1.75,1250,9486,1.0,4,1250,0,98070
347000.0,3,1.75,1330,7848,1.0,3,1330,0,98058
712000.0,3,2.0,1700,5100,1.5,4,1500,200,98117
429000.0,4,2.5,2100,7920,1.5,4,1400,700,98126
625000.0,4,2.25,2100,8290,2.0,4,2100,0,98006
349000.0,3,1.75,1690,5080,1.0,3,1190,500,98106
365000.0,3,2.0,2140,26600,1.0,4,2140,0,98031
487500.0,3,2.5,1810,1988,2.0,3,1350,460,98199
475000.0,3,2.5,2600,7210,2.0,3,2600,0,98059
685000.0,3,1.75,1650,8400,1.0,3,1470,180,98040
428000.0,3,2.25,2600,15000,2.0,3,2600,0,98038
435000.0,3,2.5,1930,5790,2.0,4,1930,0,98011
352000.0,3,2.5,2090,3002,2.0,3,1670,420,98019
622500.0,3,2.5,2290,14374,2.0,3,2290,0,98075
499950.0,3,1.5,1360,11250,1.0,4,1360,0,98006
400000.0,4,2.0,1670,12056,1.0,3,1670,0,98028
685000.0,3,2.5,2370,4950,2.0,3,2370,0,98029
396500.0,3,2.5,2590,18980,1.0,4,2590,0,98042
575000.0,4,2.0,1660,4800,1.5,3,1660,0,98103
272000.0,3,1.5,1760,9600,1.0,4,1760,0,98031
355000.0,4,2.25,1810,4970,2.0,3,1810,0,98059
848000.0,3,2.75,2170,2738,1.5,4,1550,620,98109
577000.0,3,2.25,2370,7878,2.0,3,2370,0,98034
645000.0,4,1.75,1550,7350,1.5,4,1550,0,98040
337000.0,4,2.5,2610,5240,2.0,3,2610,0,98038
280000.0,3,1.75,1230,8250,1.0,3,1230,0,98058
495000.0,4,2.5,2370,15336,2.0,3,2370,0,98024
412500.0,3,1.75,1660,10716,1.0,3,1100,560,98034
425000.0,3,2.25,1870,9000,1.0,3,1440,430,98011
340000.0,4,2.25,2180,8000,1.0,4,1630,550,98023
537100.0,3,2.5,2450,7051,1.0,3,1870,580,98056
329950.0,3,1.75,1360,13320,1.0,4,1360,0,98059
490000.0,3,2.5,2230,5348,2.0,3,2230,0,98065
579000.0,3,2.5,1710,1904,2.0,3,1140,570,98116
362500.0,4,1.75,1450,8450,1.0,3,1450,0,98027
234000.0,4,2.0,1630,9010,1.0,4,1050,580,98092
420000.0,4,2.5,2170,10500,1.0,3,1570,600,98155
775000.0,4,1.75,1890,4800,1.5,3,1390,500,98119
436800.0,3,1.75,2080,12714,2.0,4,1540,540,98052
620000.0,3,1.75,2040,4005,1.5,4,1740,300,98117
570000.0,3,2.5,2400,6975,2.0,3,2400,0,98056
615000.0,3,2.25,1870,4894,2.0,4,1750,120,98033
585000.0,3,2.5,2330,33750,2.0,3,2330,0,98045
765000.0,3,2.0,1570,7000,2.0,4,1050,520,98122
519000.0,3,1.75,1560,26099,1.0,4,1560,0,98070
550000.0,4,2.75,2160,5005,1.0,3,1430,730,98115
291000.0,3,2.25,1860,13939,1.0,4,1860,0,98030
335000.0,4,1.75,1950,13440,1.5,4,1950,0,98065
415000.0,3,1.5,1860,9003,1.0,3,1490,370,98028
270000.0,3,1.75,1610,6205,1.0,4,1210,400,98023
425000.0,3,2.5,1230,23522,1.0,4,1230,0,98059
725000.0,4,2.5,2130,3420,1.5,4,1730,400,98103
700000.0,3,2.75,2190,11060,1.0,4,1610,580,98033
396000.0,3,2.25,1680,9766,2.0,3,1680,0,98019
547000.0,3,2.5,1480,8381,1.0,4,1480,0,98125
302000.0,4,1.5,1790,10200,1.0,4,1210,580,98030
633000.0,4,2.5,2360,10000,1.0,3,1980,380,98126
265800.0,3,1.75,1460,7361,1.0,3,1460,0,98019
530000.0,3,2.25,2160,8114,1.0,3,1460,700,98133
489000.0,4,2.5,2170,4587,2.0,3,2170,0,98065
653675.0,4,2.25,2280,7229,2.0,4,2280,0,98027
245000.0,3,1.75,1260,8614,1.0,4,1260,0,98038
510000.0,3,2.5,1830,8133,1.0,3,1390,440,98028
390000.0,3,2.5,1610,10292,1.0,4,1190,420,98056
606500.0,3,2.5,2170,5500,2.0,3,2170,0,98075
290000.0,3,2.25,1620,7772,2.0,4,1620,0,98003
500000.0,3,2.5,1940,37565,1.0,4,1940,0,98027
580050.0,3,2.5,2360,4638,2.0,3,2360,0,98115
550000.0,3,2.5,2010,2261,2.0,3,1390,620,98029
500000.0,3,2.25,2010,7447,2.0,3,2010,0,98028
735000.0,3,1.75,2250,11520,1.0,3,2250,0,98028
276750.0,3,2.0,1620,12482,1.0,4,1290,330,98042
234000.0,4,2.5,1820,8217,1.0,3,1120,700,98001
234950.0,3,2.0,1510,9153,1.0,4,1510,0,98001
495000.0,3,2.5,1800,7318,2.0,3,1800,0,98029
260000.0,3,1.75,2160,22702,1.0,4,2160,0,98019
200126.0,3,2.5,2040,15463,1.0,3,1340,700,98003
290700.0,3,2.5,1670,6666,2.0,4,1670,0,98038
400000.0,3,1.75,1510,8385,1.0,3,1510,0,98034
765000.0,3,2.5,2310,11993,2.0,3,2310,0,98006
346000.0,4,2.5,2100,3916,2.0,3,2100,0,98058
260000.0,4,1.75,2010,10816,1.0,3,1410,600,98178
825000.0,4,2.5,2180,4000,2.0,3,2180,0,98122
610000.0,3,2.5,2260,33042,1.0,3,1660,600,98077
250000.0,4,1.75,1510,5500,1.5,3,1510,0,98106
470000.0,4,2.5,2470,8536,2.0,3,2470,0,98155
299999.0,4,2.5,1981,4828,2.0,3,1981,0,98092
255000.0,3,1.75,1590,7810,1.0,4,1590,0,98002
729000.0,3,1.5,1770,30689,1.0,3,1770,0,98177
479000.0,3,2.5,1710,8998,2.0,3,1710,0,98052
320000.0,4,1.5,1890,43560,1.0,4,1890,0,98092
359800.0,4,2.5,2390,6426,2.0,3,2390,0,98092
239900.0,3,2.0,1410,7566,1.0,3,1410,0,98030
380000.0,3,2.5,2150,25705,1.5,3,2150,0,98058
500000.0,3,1.5,1680,17409,1.0,3,1680,0,98033
345000.0,3,2.5,1540,3237,2.0,3,1540,0,98065
485000.0,4,1.75,2050,8913,1.0,3,1330,720,98052
443000.0,3,2.25,1920,8223,2.0,4,1920,0,98011
640000.0,4,2.0,2560,7798,1.0,4,1890,670,98115
415000.0,3,2.0,1410,4303,1.5,4,1410,0,98108
717000.0,4,2.5,2540,4241,2.0,3,2540,0,98052
548000.0,4,1.75,1690,7794,1.0,3,1090,600,98033
557500.0,3,1.75,1900,11165,1.0,4,1900,0,98008
475000.0,3,2.25,1580,12177,1.0,3,1200,380,98074
357500.0,3,1.75,1630,9403,1.0,3,1630,0,98155
330000.0,4,2.5,1940,3784,2.0,3,1940,0,98058
310000.0,3,2.0,1350,11150,1.0,3,1110,240,98045
322000.0,4,2.5,2280,7200,2.0,3,2280,0,98030
505000.0,3,2.5,1610,4611,2.0,3,1610,0,98029
417000.0,3,1.5,1340,10224,1.0,4,1340,0,98006
350000.0,3,2.25,1840,9929,1.0,3,1200,640,98028
625000.0,3,1.75,1840,5664,2.0,3,1270,570,98115
485000.0,3,1.75,2200,7706,2.0,3,2200,0,98198
242050.0,3,2.5,2170,9900,1.0,3,1690,480,98038
246000.0,3,1.75,1440,11325,1.0,4,1440,0,98001
194000.0,4,2.0,1760,7700,1.0,4,1760,0,98003
395000.0,3,2.0,1470,10125,1.0,4,1470,0,98011
574800.0,3,1.5,1630,2946,1.5,4,1630,0,98115
770000.0,3,2.5,2430,54059,2.0,3,2430,0,98027
525000.0,3,1.5,1940,5625,1.0,4,1440,500,98117
419000.0,3,2.5,1970,4058,2.0,3,1970,0,98065
333000.0,4,1.75,1880,9880,1.0,4,1880,0,98058
666000.0,3,2.5,2140,2868,2.0,3,1770,370,98052
310000.0,4,2.75,2370,7320,2.0,3,2370,0,98023
350000.0,3,2.5,1860,21876,2.0,3,1860,0,98014
564800.0,3,2.25,1990,8501,2.0,3,1990,0,98029
438000.0,3,2.25,1820,9150,1.0,3,1320,500,98133
229000.0,3,2.5,1190,3000,2.0,3,1190,0,98178
532500.0,4,2.0,2220,23750,1.0,3,2220,0,98011
335000.0,4,2.5,1750,8476,1.0,4,1240,510,98058
415000.0,3,2.5,1710,4920,2.0,3,1710,0,98126
335000.0,4,2.5,1830,4500,2.0,3,1830,0,98038
592500.0,4,1.5,2080,4400,1.5,3,2080,0,98122
418900.0,3,1.5,1470,11112,1.0,3,1470,0,98155
545000.0,3,2.0,1340,7200,1.5,4,1340,0,98118
183750.0,3,2.5,1770,3451,2.0,3,1770,0,98055
330000.0,4,2.0,1170,4000,1.0,3,1170,0,98144
620000.0,3,2.25,1990,6256,1.0,3,1390,600,98033
320000.0,4,1.75,1710,10480,1.5,4,1710,0,98059
525000.0,3,2.5,1740,2350,2.0,3,1120,620,98112
275000.0,3,1.75,1860,15681,1.0,4,1860,0,98023
460000.0,3,2.0,2930,29136,2.0,3,2240,690,98010
481450.0,3,2.0,1410,4800,1.0,3,1410,0,98117
860000.0,3,2.0,2090,4190,1.5,4,1490,600,98122
274000.0,3,1.75,1400,8364,1.0,4,1400,0,98056
220000.0,3,1.75,1290,8250,1.0,3,1290,0,98001
295000.0,3,2.0,1830,17321,1.0,4,1100,730,98178
230000.0,3,2.0,1410,10625,1.0,3,1410,0,98042
369900.0,3,1.75,2150,19127,1.0,3,1650,500,98168
405000.0,4,2.5,1850,9136,2.0,3,1850,0,98059
282000.0,3,2.5,1680,15711,1.0,3,1240,440,98031
526500.0,3,2.5,1860,43170,2.0,3,1860,0,98072
475000.0,3,2.5,2130,8022,2.0,3,2130,0,98052
315000.0,4,2.0,1210,4250,1.0,4,1210,0,98108
295000.0,3,2.5,1570,6932,2.0,3,1570,0,98038
383000.0,3,2.25,2090,15000,1.0,3,2090,0,98045
242000.0,3,2.25,1690,7292,1.0,3,1250,440,98003
515000.0,3,1.75,1190,4500,1.0,3,1190,0,98116
424000.0,3,1.5,1230,7200,1.0,3,1230,0,98125
199000.0,4,2.0,1440,9477,1.0,3,1440,0,98056
350000.0,4,2.25,2220,6953,2.0,4,2220,0,98038
415000.0,3,1.75,1640,6435,1.0,3,1190,450,98034
620000.0,3,2.5,2480,9041,2.0,3,2480,0,98053
270000.0,4,2.75,1990,7252,1.0,3,1270,720,98002
236000.0,4,2.25,1830,9485,1.0,4,1200,630,98023
299000.0,4,2.25,2050,26000,2.0,4,2050,0,98042
410000.0,4,2.5,2510,5258,2.0,3,2510,0,98056
588000.0,4,2.25,2510,19550,1.0,4,1810,700,98034
420000.0,3,2.5,2390,3903,2.0,3,1970,420,98072
355000.0,4,2.25,2200,3404,2.0,3,2200,0,98038
716000.0,4,2.25,2480,9780,1.0,4,1900,580,98052
229950.0,4,1.75,1300,21000,1.0,4,1300,0,98001
285000.0,3,2.25,1840,6214,1.0,4,1270,570,98031
537000.0,4,2.0,1560,7104,1.5,3,1140,420,98105
213675.0,3,2.25,1560,6013,2.0,3,1560,0,98023
550000.0,3,2.0,1490,3880,1.0,3,1490,0,98107
472500.0,3,2.0,1790,6800,1.0,4,1240,550,98133
299000.0,4,2.5,2350,6958,2.0,3,2350,0,98092
273950.0,3,2.25,1570,3109,2.0,3,1570,0,98092
255000.0,3,2.5,1720,6200,2.0,3,1720,0,98022
240000.0,3,1.75,1520,9600,1.0,3,1520,0,98023
670000.0,4,2.25,2040,7031,2.0,3,2040,0,98033
245000.0,3,1.5,1340,7391,1.0,4,1340,0,98198
270000.0,3,2.5,1660,5550,2.0,3,1660,0,98198
330000.0,3,2.25,1860,11227,2.0,3,1860,0,98038
250000.0,3,1.5,2030,14400,1.0,4,1310,720,98001
260000.0,4,2.0,1480,8625,1.0,4,1480,0,98055
373500.0,4,2.5,2610,4978,2.0,3,2610,0,98038
450000.0,3,2.25,1760,10013,2.0,4,1760,0,98056
379950.0,3,1.75,2040,12065,1.0,3,2040,0,98038
452000.0,3,1.5,1250,4000,1.0,3,1250,0,98117
465000.0,4,2.0,2000,6250,1.5,3,1480,520,98136
295000.0,3,2.5,2030,4867,2.0,3,2030,0,98042
300523.0,3,2.5,2370,6840,2.0,3,2370,0,98119
305950.0,4,2.5,2007,4968,2.0,3,2007,0,98092
220000.0,3,2.5,1430,9044,2.0,3,1430,0,98022
400000.0,4,2.0,2070,10800,2.0,3,2070,0,98011
865000.0,4,2.5,2520,4950,2.0,3,2520,0,98117
550000.0,3,2.5,1680,10455,2.0,3,1680,0,98052
327000.0,3,2.5,1810,7350,1.0,3,1310,500,98058
521000.0,3,2.0,1840,6000,1.0,4,1840,0,98136
375000.0,3,1.5,2000,7294,1.0,3,1520,480,98118
235000.0,3,1.75,1480,6592,1.0,4,1080,400,98023
240000.0,4,2.5,2040,11841,2.0,3,2040,0,98042
575000.0,4,2.25,2060,12155,1.0,4,2060,0,98008
249950.0,3,2.0,1550,15040,1.0,4,1550,0,98059
431000.0,3,2.5,1690,2752,2.0,3,1690,0,98052
605000.0,3,2.25,1290,2500,2.0,4,1290,0,98112
234950.0,4,2.0,1450,7560,1.0,3,1450,0,98001
392000.0,4,2.5,2600,8921,2.0,3,2600,0,98058
297950.0,3,2.0,1390,5127,1.0,3,1390,0,98055
310000.0,3,2.0,2010,12950,1.0,3,2010,0,98034
401000.0,3,2.0,1240,11172,1.0,3,1000,240,98074
251000.0,3,1.5,1590,21600,1.5,4,1590,0,98022
300000.0,4,2.5,1840,5550,2.0,3,1840,0,98031
610000.0,4,2.25,1960,9021,2.0,4,1960,0,98052
430000.0,3,2.25,1830,19965,1.0,3,1400,430,98072
561000.0,3,1.75,1710,5000,1.0,4,1360,350,98136
380000.0,4,2.5,1940,3200,2.0,3,1940,0,98058
329500.0,3,2.25,1500,9656,1.0,3,1170,330,98019
500000.0,3,2.25,1700,9008,1.0,3,1340,360,98125
415000.0,4,1.5,1840,11367,1.5,4,1840,0,98177
367000.0,4,2.5,2350,8182,2.0,3,2350,0,98042
462600.0,3,2.0,1320,4000,1.0,4,1020,300,98118
875000.0,3,2.5,1690,10592,1.0,3,1690,0,98040
335000.0,3,2.25,2060,47318,1.0,4,1600,460,98001
671000.0,4,2.75,1890,1475,2.0,3,1200,690,98199
245000.0,3,2.25,1900,7250,1.0,3,1250,650,98146
495500.0,3,1.75,2130,6360,1.0,3,1720,410,98125
450000.0,4,2.0,1570,7320,1.0,4,1570,0,98007
280000.0,4,2.25,1930,7207,1.0,4,1360,570,98030
795000.0,3,1.75,1930,9600,1.0,3,1930,0,98040
839000.0,4,2.75,2400,12469,1.0,4,1760,640,98008
440000.0,3,2.25,1900,7225,1.0,3,1220,680,98008
405000.0,4,2.5,2090,6667,2.0,3,2090,0,98058
275000.0,4,2.5,1840,1562,2.0,3,1400,440,98106
790100.0,4,2.5,2590,9341,2.0,3,2590,0,98052
220000.0,4,2.5,2160,8005,2.0,3,2160,0,98001
367300.0,4,2.75,2190,14937,2.0,3,2190,0,98001
805000.0,4,2.0,1890,4500,1.5,3,1490,400,98103
402000.0,3,2.0,1720,7704,1.0,4,1160,560,98011
458000.0,3,1.5,1570,12196,1.0,4,1570,0,98045
308000.0,4,2.5,1960,5642,2.0,3,1960,0,98092
385000.0,3,2.5,2230,8296,2.0,3,2230,0,98058
240000.0,3,1.75,1260,7362,1.0,3,1260,0,98038
217000.0,3,1.5,1860,8505,1.0,4,1860,0,98023
585000.0,3,2.5,2290,5089,2.0,3,2290,0,98006
585000.0,3,2.5,2290,5089,2.0,3,2290,0,98006
368750.0,3,2.5,2230,5717,2.0,3,2230,0,98058
589000.0,3,2.5,2250,4337,2.0,3,2250,0,98075
316500.0,3,2.5,1770,3873,2.0,3,1770,0,98058
240000.0,3,1.5,1890,9000,1.0,3,1190,700,98188
625000.0,4,2.25,1920,8259,2.0,4,1920,0,98027
270000.0,3,2.25,1740,7345,1.0,3,1380,360,98032
360000.0,3,1.75,1300,7770,1.0,3,1300,0,98034
412000.0,4,1.75,1430,10500,1.0,4,1130,300,98007
426000.0,4,2.25,2120,7700,1.0,4,1490,630,98034
266000.0,4,2.25,1860,12693,1.0,3,1140,720,98023
310000.0,3,1.75,2130,7140,1.0,3,1580,550,98023
340000.0,4,1.75,1900,7313,1.0,3,1900,0,98034
633000.0,4,2.5,2020,8044,2.0,3,2020,0,98074
270000.0,3,2.5,1720,8550,1.0,4,1720,0,98002
299500.0,3,1.75,1820,8813,2.0,3,1820,0,98003
522500.0,3,1.75,1710,9707,1.0,4,1710,0,98008
352000.0,3,1.75,1260,7200,1.0,3,1260,0,98034
267000.0,3,2.5,1580,12250,2.0,3,1580,0,98198
905000.0,4,2.25,2240,5000,2.0,3,1770,470,98122
274000.0,4,1.75,1940,7500,1.0,4,1720,220,98030
475000.0,3,1.75,1850,26445,1.0,4,1850,0,98010
260000.0,3,1.5,1580,8184,1.0,3,1140,440,98148
690000.0,3,1.75,1600,4400,1.0,3,1030,570,98112
360000.0,4,2.5,2610,7333,2.0,3,2610,0,98003
285000.0,3,1.75,1630,4000,1.0,3,1100,530,98106
340000.0,4,2.5,1910,7201,1.0,3,1210,700,98198
405100.0,4,2.0,1580,7300,1.0,4,1580,0,98155
464000.0,3,2.5,1690,4898,2.0,3,1690,0,98053
723000.0,4,2.25,1960,8680,1.0,4,1290,670,98004
690000.0,4,2.0,1760,7800,1.0,3,1760,0,98117
358800.0,4,2.5,2155,8140,2.0,3,2155,0,98031
209950.0,3,1.5,1180,7300,1.0,4,1180,0,98002
283748.0,3,2.25,1940,9560,2.0,3,1940,0,98023
370000.0,3,2.25,1600,7620,1.0,3,1280,320,98011
396900.0,3,2.0,1360,3120,2.0,3,1360,0,98115
321000.0,3,2.5,2014,4500,2.0,3,2014,0,98001
245000.0,3,2.0,1440,7008,1.0,3,1440,0,98030
257000.0,4,2.75,2330,7642,1.0,3,1800,530,98023
485000.0,4,2.25,1850,9911,1.0,4,1850,0,98008
500000.0,4,2.5,2230,8560,2.0,3,2230,0,98059
475000.0,3,1.75,1720,3825,1.5,3,1720,0,98105
410000.0,3,2.25,1450,19206,2.0,3,1450,0,98074
490000.0,4,2.5,2570,6157,2.0,3,2570,0,98065
348500.0,4,1.75,1870,7575,1.0,3,1480,390,98034
268000.0,3,1.75,1600,7711,1.0,3,1600,0,98002
299000.0,4,2.25,1870,6693,2.0,3,1870,0,98003
430000.0,4,1.5,1810,7200,1.0,3,1810,0,98034
345000.0,3,1.75,1860,7191,1.0,4,1260,600,98058
351000.0,4,2.5,2370,7274,2.0,3,2370,0,98031
745000.0,4,2.25,2290,10409,2.0,3,2290,0,98005
555700.0,3,2.0,1810,12420,1.0,4,1810,0,98008
449000.0,3,1.75,1660,9697,1.0,4,1660,0,98155
370000.0,3,2.0,1860,9100,1.5,3,1860,0,98155
239000.0,3,1.75,1340,16480,1.0,4,1340,0,98042
345000.0,4,2.25,2320,7350,2.0,3,2320,0,98058
289000.0,3,2.5,2110,8304,1.0,4,2110,0,98030
245000.0,3,2.25,2210,10794,1.0,3,1540,670,98178
520000.0,3,2.25,2210,10794,1.0,3,1540,670,98178
352500.0,3,2.25,1410,14110,1.0,3,1170,240,98065
872500.0,3,2.5,2040,6000,1.0,3,1840,200,98109
225000.0,3,1.5,1660,7221,1.0,3,980,680,98168
735000.0,4,2.0,1640,6000,1.5,4,1640,0,98119
279950.0,3,1.75,1720,9775,1.0,3,1720,0,98032
310000.0,3,2.25,1960,2345,2.0,3,1750,210,98118
507000.0,3,2.5,2120,7201,2.0,3,2120,0,98133
230000.0,3,2.5,1340,3011,2.0,3,1340,0,98038
509900.0,3,1.75,1690,53578,1.0,3,1690,0,98053
370000.0,4,2.5,2570,7753,2.0,3,2570,0,98058
619100.0,3,1.75,1870,7030,1.0,3,1870,0,98033
335000.0,3,2.5,2588,5701,2.0,3,2588,0,98042
500000.0,3,1.75,1690,48096,1.0,3,1690,0,98053
374000.0,4,2.5,2580,6260,2.0,3,2580,0,98056
473000.0,3,2.25,1620,12309,2.0,3,1620,0,98074
540000.0,3,1.75,2590,25992,1.0,3,1970,620,98029
450000.0,3,2.75,1250,892,2.0,3,1040,210,98116
244000.0,3,1.75,1500,7475,1.0,4,1500,0,98023
542000.0,3,2.25,2220,12056,2.0,3,2220,0,98052
289950.0,3,2.5,1770,9450,1.0,3,1770,0,98001
250000.0,4,2.75,1830,6643,2.0,3,1830,0,98001
515000.0,4,1.5,1740,8160,1.5,4,1400,340,98177
336600.0,3,2.25,1654,8464,2.0,3,1654,0,98038
480000.0,4,2.5,2180,9861,2.0,3,2180,0,98045
725000.0,3,1.75,1860,6000,2.0,4,1860,0,98144
585000.0,4,2.5,1950,3720,2.0,3,1950,0,98029
678700.0,3,1.75,1970,10548,1.0,4,1300,670,98033
603000.0,4,2.25,2110,11155,2.0,3,2110,0,98074
715000.0,3,1.75,1650,7276,1.5,4,1150,500,98117
359000.0,3,2.25,1650,7218,1.0,3,1230,420,98133
450000.0,3,2.25,2450,42180,1.0,4,2450,0,98042
615000.0,3,2.5,1980,3128,2.0,3,1890,90,98027
283500.0,4,2.5,1990,5577,2.0,3,1990,0,98092
370000.0,4,2.5,2320,9264,2.0,3,2320,0,98188
684680.0,4,2.25,2370,9360,2.0,4,2370,0,98052
250000.0,3,2.5,1610,6600,2.0,3,1610,0,98003
442500.0,4,2.25,1840,7575,1.0,4,1390,450,98034
699000.0,3,2.0,1820,4080,2.0,3,1820,0,98107
237000.0,3,2.0,1210,6634,1.0,4,1210,0,98031
399950.0,3,2.25,1560,11997,1.0,3,1260,300,98065
605000.0,3,2.25,2260,17114,2.0,3,2260,0,98155
295000.0,4,2.5,1850,8198,2.0,3,1850,0,98031
513000.0,4,2.5,1930,8040,1.0,3,1380,550,98034
339999.0,3,2.5,2360,8093,2.0,3,2360,0,98092
250000.0,3,2.0,1500,5200,1.0,3,1060,440,98042
400000.0,4,1.75,1770,12875,1.0,3,1770,0,98028
570000.0,3,2.0,1930,10929,1.0,3,1260,670,98155
330490.0,3,2.75,1440,7350,1.0,4,1040,400,98058
325000.0,3,2.5,1740,5267,2.0,3,1740,0,98038
335000.0,3,2.5,1740,5267,2.0,3,1740,0,98038
809000.0,3,2.5,2590,7720,2.0,3,2590,0,98007
340000.0,4,2.5,2380,9362,2.0,3,2380,0,98023
493000.0,3,2.75,1720,6720,1.0,4,1270,450,98122
334000.0,3,2.25,2000,7225,2.0,4,2000,0,98030
295000.0,4,1.75,1800,28650,1.0,4,1800,0,98031
475000.0,4,1.75,1650,7775,1.0,4,1150,500,98133
425000.0,4,2.75,1680,9545,1.0,4,1080,600,98028
307000.0,4,2.0,2390,23972,2.0,3,1720,670,98023
635000.0,3,2.5,2300,5500,1.5,4,2000,300,98144
223000.0,3,1.75,1340,7473,1.0,4,1340,0,98002
425000.0,3,2.75,2600,10874,2.0,3,2600,0,98042
190000.0,3,2.25,1640,7730,1.0,4,1220,420,98038
275000.0,4,1.75,1960,6177,1.0,4,1960,0,98023
450000.0,3,2.5,1480,1961,2.0,3,1480,0,98029
550000.0,4,2.0,1540,5000,1.5,4,1540,0,98105
572500.0,3,2.0,2290,11200,2.0,3,2290,0,98052
464500.0,4,2.5,1750,11381,1.0,4,1610,140,98155
530000.0,3,1.75,1690,8190,1.0,4,1690,0,98005
436000.0,4,2.0,1600,15044,1.0,3,1600,0,98034
880000.0,4,1.75,2510,5800,1.0,4,1830,680,98199
344500.0,3,1.75,1890,9535,1.0,3,1210,680,98055
375000.0,4,2.75,1430,7403,1.0,3,1030,400,98106
330000.0,4,2.5,2105,6093,2.0,3,2105,0,98042
450000.0,3,1.5,1340,7200,1.0,3,1340,0,98034
635000.0,4,1.75,2460,7560,2.0,4,2460,0,98177
281000.0,4,2.25,1677,3600,2.0,3,1677,0,98092
655275.0,3,1.75,2050,11856,1.0,3,1460,590,98006
246000.0,3,2.5,1650,6675,1.0,3,1290,360,98023
650000.0,3,2.5,2350,3750,2.0,3,1740,610,98117
398000.0,4,2.5,2050,14724,2.0,3,2050,0,98019
502000.0,3,2.5,1870,9135,1.0,3,1250,620,98074
375000.0,3,1.5,1190,20672,1.5,3,1190,0,98166
248000.0,4,2.5,1770,5855,2.0,3,1770,0,98038
336750.0,4,2.25,1720,7803,1.0,3,1350,370,98146
645000.0,4,2.75,2330,3917,2.0,3,2330,0,98029
279000.0,3,2.5,1660,7388,2.0,3,1660,0,98038
466000.0,3,2.25,1880,7279,1.0,3,1280,600,98155
361500.0,4,2.75,2190,6740,2.0,3,2190,0,98038
404000.0,3,1.75,1720,7202,1.0,3,1720,0,98056
320000.0,3,1.5,1490,10132,1.0,4,1490,0,98059
660000.0,4,2.5,2290,9120,2.0,4,2290,0,98006
300000.0,4,1.75,1820,5015,1.0,4,1190,630,98108
381500.0,4,2.5,2430,5556,2.0,4,2430,0,98042
278226.0,4,2.5,2390,4639,2.0,3,2390,0,98038
760000.0,4,2.5,2420,10285,1.0,3,1700,720,98146
195000.0,4,1.5,2170,9948,2.0,3,2170,0,98148
564000.0,4,1.75,1960,6138,1.0,4,1260,700,98115
539500.0,4,2.25,2280,8550,1.0,3,1660,620,98034
290000.0,4,2.5,1850,5674,2.0,3,1850,0,98042
464550.0,3,1.5,1690,10500,1.0,4,1690,0,98033
409950.0,3,1.75,1320,6030,1.0,4,1320,0,98052
497950.0,4,2.5,1950,3000,2.0,3,1550,400,98118
453500.0,4,1.75,2000,6032,1.0,3,1300,700,98146
215000.0,4,2.25,1900,9600,1.0,4,1900,0,98031
802000.0,3,2.5,2580,13096,2.0,3,2580,0,98052
330000.0,4,2.5,2340,11784,2.0,3,2340,0,98042
549800.0,3,2.25,1580,11680,1.0,4,1580,0,98005
338000.0,3,2.5,1590,7819,2.0,3,1590,0,98055
383000.0,4,2.5,1850,8310,1.0,3,1200,650,98155
257000.0,3,1.75,1430,7210,1.0,3,1430,0,98031
335000.0,4,2.75,2190,9209,2.0,4,2190,0,98092
422000.0,4,2.5,2310,6650,2.0,3,2310,0,98166
665000.0,3,2.5,2330,15536,1.0,3,2330,0,98074
250000.0,4,2.0,1470,7412,1.0,3,1470,0,98198
349950.0,3,2.5,2390,6441,2.0,3,2390,0,98038
395000.0,4,2.5,2250,6840,2.0,3,2250,0,98058
273500.0,3,1.5,2000,15265,1.0,3,1540,460,98032
699000.0,3,2.5,2370,10968,2.0,4,2370,0,98033
405000.0,3,1.5,1240,9975,1.0,3,1240,0,98024
266750.0,3,2.25,1650,10000,2.0,3,1650,0,98198
431000.0,4,2.5,1450,3600,1.5,3,1250,200,98144
262000.0,4,1.5,1840,9009,2.0,3,1840,0,98198
295000.0,3,1.75,1520,6559,1.0,4,1170,350,98038
615000.0,3,1.75,2110,56192,1.0,3,1480,630,98072
370000.0,3,1.5,1560,6774,1.0,4,1060,500,98133
210000.0,3,2.25,2140,9775,1.0,4,1470,670,98023
375000.0,3,1.75,2530,35150,1.0,4,1800,730,98042
565000.0,4,2.0,2070,7980,1.5,4,2070,0,98146
339950.0,4,2.25,2670,9040,1.0,3,2170,500,98148
439950.0,3,2.5,1770,2875,2.0,3,1770,0,98116
207000.0,3,2.5,1520,2550,2.0,3,1520,0,98108
510000.0,4,1.5,1320,14250,1.0,4,1320,0,98033
180000.0,3,2.25,1990,6350,2.0,3,1990,0,98198
309950.0,3,2.25,1990,6350,2.0,3,1990,0,98198
620000.0,4,2.25,1890,4300,1.5,3,1350,540,98103
330000.0,3,2.5,1990,9995,2.0,3,1990,0,98198
525000.0,4,1.75,1600,7400,1.0,3,1210,390,98125
294000.0,4,2.5,2210,8465,1.0,3,1490,720,98092
463000.0,3,1.75,2020,11095,1.0,4,1480,540,98034
320900.0,3,2.0,1770,7251,1.0,4,1770,0,98031
369950.0,4,2.5,2050,4502,2.0,3,2050,0,98059
400000.0,4,1.75,1810,9750,2.0,4,1810,0,98155
458000.0,3,2.25,2150,9900,1.0,3,1450,700,98052
436000.0,4,2.5,2495,5751,2.0,3,2495,0,98019
250000.0,3,2.25,1900,9990,1.0,3,1300,600,98003
430000.0,3,1.5,1450,7316,1.0,3,1450,0,98133
383900.0,3,1.5,1600,8040,1.0,4,1050,550,98133
330000.0,4,2.5,2210,5929,2.0,3,2210,0,98042
624000.0,3,2.5,2510,47044,1.0,4,1910,600,98072
275000.0,3,2.0,1380,3500,2.0,3,1380,0,98118
275000.0,3,2.5,1870,6821,2.0,3,1870,0,98023
190000.0,3,1.75,1350,7370,1.0,4,1350,0,98118
300000.0,3,1.75,1350,7370,1.0,4,1350,0,98118
540000.0,3,2.0,1470,1691,2.0,3,1000,470,98115
275000.0,4,1.75,1680,19405,1.0,4,1560,120,98055
370000.0,3,2.75,2120,7650,1.0,4,2120,0,98056
797000.0,3,2.5,1370,1911,2.0,3,1370,0,98109
329950.0,3,2.25,2070,7995,1.0,3,1350,720,98031
220000.0,3,2.25,1470,7518,1.0,3,1160,310,98003
375000.0,3,1.75,1430,8412,1.0,4,1070,360,98125
388000.0,3,1.75,1760,9277,1.0,4,1760,0,98146
705000.0,4,1.75,1690,11739,1.0,4,1690,0,98040
740000.0,4,2.25,2230,6000,1.5,3,1810,420,98199
359000.0,3,1.5,1550,4980,1.0,3,1080,470,98133
334950.0,4,2.5,2230,5500,2.0,3,2230,0,98038
253000.0,4,2.5,2230,4541,2.0,3,2230,0,98042
561000.0,3,2.25,1710,4140,2.0,3,1710,0,98029
252000.0,4,1.75,1940,13370,1.0,4,1940,0,98023
419950.0,4,1.75,1870,16549,1.0,3,1870,0,98072
400000.0,3,2.25,2140,11266,2.0,3,2140,0,98019
355900.0,3,2.5,2090,3821,2.0,3,2090,0,98038
518000.0,4,1.75,2560,15000,1.0,3,1880,680,98075
402000.0,3,2.5,1520,3425,2.0,3,1520,0,98052
500000.0,4,2.0,1980,4500,2.0,4,1980,0,98107
345000.0,3,2.25,1690,14615,2.0,4,1690,0,98045
355000.0,4,2.5,2150,3600,2.0,3,2150,0,98038
390000.0,3,1.5,1180,7700,1.0,4,1180,0,98007
448500.0,3,1.75,1300,4800,2.0,4,1300,0,98136
346000.0,3,1.75,1590,9636,1.5,4,1590,0,98155
779000.0,3,1.75,1990,5600,1.0,3,1330,660,98199
335000.0,3,1.75,1510,9720,1.0,3,1510,0,98028
305000.0,3,2.25,1630,10962,1.0,4,1100,530,98030
610000.0,3,2.25,2320,38186,2.0,3,2320,0,98053
250000.0,3,2.5,1650,2802,2.0,3,1650,0,98055
619000.0,3,2.5,2560,43608,2.0,3,2560,0,98077
465000.0,4,2.5,2590,16437,2.0,3,2590,0,98038
276900.0,3,2.5,1620,7320,2.0,3,1620,0,98038
660000.0,3,2.25,1700,12615,1.0,4,1300,400,98033
480000.0,3,2.5,2450,28185,2.0,3,2450,0,98058
593567.0,3,2.5,1770,3205,2.0,3,1770,0,98052
440000.0,3,2.5,2060,11231,2.0,3,2060,0,98072
422500.0,3,2.0,1300,2250,2.0,3,1300,0,98103
565000.0,4,2.5,2330,7936,2.0,3,2330,0,98074
725000.0,4,1.75,2350,7574,1.0,3,1720,630,98027
595000.0,4,1.5,1350,8113,1.0,4,1350,0,98004
366000.0,3,2.5,1790,4065,2.0,3,1790,0,98019
300000.0,4,2.5,2400,7215,2.0,3,2400,0,98023
260000.0,3,2.25,1920,9680,1.0,4,1300,620,98031
295000.0,3,1.75,1440,4000,1.0,4,1050,390,98106
700000.0,4,1.75,2420,520,1.5,3,2420,0,98112
560000.0,3,2.0,2090,15790,1.0,3,2090,0,98034
437000.0,3,1.75,1310,9282,1.0,4,1310,0,98052
447000.0,3,2.5,1800,3074,2.0,3,1800,0,98072
485000.0,3,1.5,1870,7853,1.0,3,1300,570,98125
356000.0,3,2.25,2280,8765,2.0,3,2280,0,98058
315000.0,4,2.5,2040,6300,2.0,3,2040,0,98031
407500.0,4,2.5,1900,9075,2.0,3,1900,0,98133
520000.0,3,1.75,1540,7558,1.0,3,1540,0,98052
750000.0,3,2.0,1820,5000,1.5,4,1720,100,98116
435000.0,3,2.0,1270,10713,1.0,4,1270,0,98034
259500.0,4,1.5,1300,7200,1.0,4,1300,0,98031
517000.0,3,1.75,1740,10000,1.0,3,1740,0,98074
525000.0,4,2.0,2420,10735,1.5,3,2420,0,98052
320000.0,4,2.5,2130,9653,1.0,3,1500,630,98031
635000.0,4,1.75,1950,13320,1.0,4,1370,580,98007
400000.0,4,2.5,2150,5397,2.0,3,2150,0,98058
455000.0,3,1.75,1270,7700,1.0,4,1270,0,98052
342000.0,3,1.75,1780,10409,1.0,3,1280,500,98058
485000.0,4,2.75,1830,8384,1.0,3,1320,510,98034
385000.0,4,1.75,1800,10890,1.5,4,1800,0,98027
310000.0,4,2.0,1870,6000,1.5,3,1870,0,98125
449000.0,4,2.0,1870,6000,1.5,3,1870,0,98125
468000.0,3,2.25,1470,5597,2.0,3,1470,0,98029
392000.0,4,2.75,1940,6555,2.0,3,1940,0,98038
412500.0,4,2.25,1630,7969,1.0,3,1100,530,98034
294450.0,4,2.25,1400,7341,1.0,3,1300,100,98155
335000.0,4,2.5,2520,7205,2.0,3,2520,0,98003
322000.0,3,1.75,1400,18002,1.0,3,1400,0,98019
380000.0,4,2.0,1710,9996,1.0,3,1710,0,98108
292000.0,4,2.75,2414,7693,2.0,3,2414,0,98002
600000.0,3,2.5,2320,7609,2.0,3,2320,0,98027
435000.0,3,2.5,2530,16102,2.0,3,2530,0,98038
499950.0,3,2.5,2580,23925,2.0,3,2580,0,98023
540000.0,3,2.5,1380,1021,2.0,3,1160,220,98122
330000.0,4,2.5,2080,7000,1.0,4,1400,680,98058
474000.0,3,1.75,1530,8000,2.0,3,1530,0,98052
670000.0,4,1.75,1930,9310,1.0,4,1930,0,98008
500000.0,3,1.5,2150,4000,1.5,3,1470,680,98144
518000.0,4,2.5,1740,7500,1.0,4,1220,520,98052
251000.0,3,1.75,1220,7250,1.0,3,1220,0,98045
255000.0,3,2.0,1290,13282,1.0,3,1290,0,98030
322000.0,4,2.5,1950,4553,2.0,3,1950,0,98056
395000.0,3,2.25,1780,9672,1.0,3,1350,430,98133
583500.0,3,1.75,1720,7800,1.0,4,1170,550,98052
539000.0,3,1.75,1790,9860,1.0,4,1410,380,98052
280000.0,3,2.5,1600,7936,2.0,3,1600,0,98038
495000.0,3,1.75,1770,10080,1.0,3,1770,0,98125
362000.0,3,2.5,2310,7485,2.0,3,2310,0,98058
840000.0,4,2.5,2170,9796,1.0,4,1650,520,98006
265000.0,3,2.25,1380,7226,1.0,4,1140,240,98042
827235.0,3,1.75,1740,8560,1.0,3,1500,240,98199
400000.0,3,2.5,1950,18533,2.0,3,1950,0,98024
300499.0,4,2.5,2150,7944,2.0,3,2150,0,98092
449000.0,4,2.0,1560,5220,1.0,3,1560,0,98115
865000.0,3,1.5,1790,7526,1.0,3,1790,0,98004
245000.0,4,2.25,2190,9113,2.0,3,2190,0,98001
299950.0,3,2.25,1370,5000,2.0,3,1370,0,98019
300000.0,3,2.5,1700,3575,2.0,3,1700,0,98108
315000.0,3,1.5,1700,8067,1.0,3,1250,450,98155
480500.0,4,2.5,2180,11200,1.0,4,2180,0,98072
427500.0,4,2.5,2460,5091,2.0,3,2460,0,98058
415000.0,3,1.5,1220,835,1.5,4,1220,0,98103
490000.0,3,1.75,1470,9750,1.0,4,1470,0,98052
275000.0,3,1.5,1400,9750,1.0,4,1400,0,98030
410000.0,4,2.0,2010,9474,2.0,3,2010,0,98166
299250.0,3,2.5,2530,8669,2.0,3,2530,0,98023
431000.0,4,2.5,2300,6087,2.0,3,2300,0,98056
765000.0,3,1.75,2120,5000,2.0,3,1980,140,98103
345000.0,3,1.75,1990,5650,1.0,3,1320,670,98178
500000.0,3,1.5,1320,8100,1.0,4,1320,0,98177
200500.0,3,1.75,1260,9346,1.0,4,1260,0,98030
392500.0,4,2.0,1950,8040,1.0,3,1950,0,98125
305000.0,3,2.0,1430,12430,1.0,4,1430,0,98056
276000.0,4,2.5,2068,7242,2.0,4,2068,0,98001
264500.0,3,1.5,1580,14040,1.0,3,1050,530,98001
240000.0,3,2.5,1620,5250,2.0,3,1620,0,98003
294950.0,4,2.25,1740,9600,1.0,3,1160,580,98188
693000.0,3,2.25,2120,13644,2.0,4,1420,700,98040
635000.0,4,2.5,2070,11286,2.0,3,2070,0,98056
350000.0,4,2.5,2610,5866,2.0,3,2610,0,98038
279950.0,3,2.25,1340,7202,2.0,4,1340,0,98038
325000.0,4,2.25,1920,11603,2.0,4,1920,0,98058
652600.0,4,2.5,2220,5900,2.0,3,2220,0,98117
265000.0,3,2.5,1890,6088,2.0,3,1890,0,98002
509000.0,4,2.0,1960,2166,1.5,4,1260,700,98103
762450.0,4,1.75,2570,8640,1.0,4,2570,0,98005
465950.0,4,2.5,2340,6896,2.0,3,2340,0,98059
325000.0,3,1.75,1780,11096,1.0,3,1210,570,98074
500000.0,3,1.75,1780,11096,1.0,3,1210,570,98074
747000.0,3,1.5,1710,5120,2.0,4,1710,0,98115
395000.0,3,1.75,1740,6220,1.0,4,1740,0,98177
392500.0,3,1.75,1540,8925,1.0,4,1540,0,98133
252500.0,3,2.0,1810,10684,2.0,3,1810,0,98058
377000.0,3,1.75,1820,34800,1.0,4,1820,0,98027
396500.0,3,1.5,1360,1488,2.0,3,1120,240,98199
300000.0,4,2.5,2080,2999,2.0,3,2080,0,98059
301950.0,3,1.75,1370,9288,1.0,4,1370,0,98059
375000.0,3,1.75,1380,5060,1.0,3,1380,0,98133
374990.0,3,2.5,1300,10484,2.0,3,1300,0,98028
264000.0,3,2.25,1552,3677,2.0,3,1552,0,98092
640000.0,4,2.5,2500,7417,2.0,3,2500,0,98074
389950.0,3,2.5,2170,8140,2.0,3,2170,0,98030
485000.0,3,2.25,1570,8111,2.0,3,1570,0,98074
840000.0,4,2.5,2480,4602,2.0,3,2480,0,98052
300000.0,3,1.75,1700,8481,2.0,3,1700,0,98003
361810.0,3,1.75,1240,7620,1.0,3,1240,0,98166
500000.0,4,2.25,2350,7210,1.5,4,2350,0,98011
270000.0,3,2.25,2080,26574,1.0,3,1380,700,98002
437500.0,3,2.0,1760,2875,2.0,3,1290,470,98126
575000.0,3,1.75,1760,10349,1.0,3,1760,0,98005
278000.0,4,2.5,1940,6887,2.0,3,1940,0,98023
535000.0,4,2.5,2360,15008,1.0,3,1920,440,98028
340000.0,4,2.5,2181,5521,2.0,3,2181,0,98001
359950.0,3,1.75,1890,9100,2.0,4,1890,0,98133
210000.0,3,2.0,1830,4992,1.0,3,1230,600,98118
293000.0,3,1.75,1420,13187,1.0,4,1420,0,98059
180000.0,3,2.0,1670,7056,1.0,4,1670,0,98002
324450.0,3,2.0,1420,16000,1.0,3,1420,0,98166
450000.0,3,2.5,2450,19744,2.0,3,2450,0,98038
637000.0,4,2.5,2120,15000,2.0,4,2120,0,98052
305000.0,3,1.75,1400,10350,1.0,4,1400,0,98059
587000.0,4,2.5,2550,6256,2.0,3,2550,0,98072
507000.0,4,1.75,1770,9375,1.0,4,1170,600,98052
329990.0,4,2.75,2420,8438,2.0,3,2420,0,98022
240000.0,4,2.25,1720,8300,1.0,4,1720,0,98023
387846.0,4,1.75,2520,15205,1.0,4,2040,480,98028
367500.0,4,2.0,1960,16015,1.0,3,1960,0,98002
465000.0,3,1.75,1730,8073,1.0,3,1350,380,98177
323000.0,3,2.0,1830,6925,1.0,4,1830,0,98058
270000.0,4,2.5,1600,9921,2.0,3,1600,0,98042
445000.0,3,2.25,1860,7200,1.0,4,1240,620,98034
437400.0,3,1.75,2150,8925,1.0,4,2150,0,98008
570000.0,3,2.0,1890,29185,1.0,3,1470,420,98006
239950.0,3,1.75,1230,9600,1.0,4,1230,0,98042
465000.0,4,2.25,2140,7701,1.0,4,1470,670,98034
512500.0,3,2.5,1840,2875,2.0,4,1840,0,98116
314000.0,4,2.5,1870,8449,2.0,3,1870,0,98188
375000.0,4,2.0,2400,6000,2.0,3,2400,0,98011
310000.0,4,1.5,1220,9600,1.0,3,1220,0,98014
683000.0,3,2.5,2300,9218,2.0,3,2300,0,98027
250500.0,3,2.0,1710,7225,2.0,4,1710,0,98023
257000.0,4,1.75,1900,22896,1.5,3,1360,540,98010
475000.0,3,2.5,1700,9100,1.0,3,1160,540,98126
590000.0,3,2.5,2520,10223,2.0,3,2520,0,98074
264500.0,3,2.5,1630,8346,1.0,3,1630,0,98092
360000.0,4,2.0,1450,8940,1.0,3,1450,0,98034
439950.0,3,2.5,1540,7773,2.0,4,1540,0,98034
485000.0,4,2.5,2100,8886,2.0,4,2100,0,98007
750000.0,4,1.75,2670,6250,2.0,4,2020,650,98199
865000.0,4,2.0,2750,5527,2.0,3,2130,620,98119
375000.0,3,1.75,1660,9673,1.0,3,1130,530,98072
275000.0,3,2.5,1830,7062,2.0,3,1830,0,98023
315000.0,3,2.0,1770,9685,1.0,3,1770,0,98166
590000.0,3,2.5,2110,3870,2.0,3,2110,0,98029
300000.0,4,2.5,1960,9898,2.0,3,1960,0,98030
215000.0,3,2.0,1340,8505,1.0,3,1340,0,98168
485000.0,3,2.5,1650,3436,2.0,3,1650,0,98053
260000.0,4,1.75,1360,7700,1.0,4,1360,0,98058
254000.0,3,2.0,1480,7480,1.0,4,1480,0,98038
600000.0,4,2.5,2360,5226,2.0,3,2360,0,98034
285000.0,3,2.5,1800,2516,2.0,3,1800,0,98108
646000.0,4,2.5,2310,4079,2.0,3,2310,0,98117
300000.0,3,2.5,1880,4200,2.0,3,1880,0,98038
550000.0,3,1.75,1380,3402,1.5,3,1380,0,98122
255000.0,4,1.75,1650,7200,1.0,3,1100,550,98031
660000.0,3,1.75,2030,9032,2.0,4,2030,0,98008
212000.0,3,1.75,1470,8350,1.0,3,1470,0,98001
265000.0,3,1.75,1840,7300,1.0,3,1840,0,98023
311500.0,4,2.5,1940,10133,2.0,3,1940,0,98031
600000.0,4,2.5,2250,11370,2.0,3,2250,0,98034
600000.0,3,2.25,2230,9053,2.0,4,2230,0,98007
315000.0,3,2.5,1950,3000,2.0,3,1950,0,98146
270000.0,4,2.5,1920,8497,2.0,3,1920,0,98092
300000.0,4,1.5,1460,8760,1.0,3,1460,0,98166
264950.0,3,1.5,1370,10115,1.0,4,1370,0,98022
855000.0,4,2.25,2480,36974,2.0,4,2480,0,98005
289950.0,3,2.5,2070,5013,2.0,3,2070,0,98023
792000.0,3,2.5,2250,19270,2.0,3,2250,0,98074
295500.0,3,1.75,1330,10523,1.0,3,1000,330,98055
495000.0,4,2.5,2310,7555,2.0,3,2310,0,98155
672500.0,3,1.75,1580,5750,1.0,4,1330,250,98199
405000.0,3,2.5,1500,9636,2.0,3,1500,0,98011
753000.0,4,1.75,2160,39430,1.0,4,1660,500,98005
365000.0,3,1.5,1520,8519,1.0,3,1520,0,98133
321000.0,4,2.5,1830,9601,2.0,3,1830,0,98038
280000.0,3,2.5,1550,4486,2.0,3,1550,0,98001
288000.0,3,2.5,1520,3593,2.0,3,1520,0,98038
330000.0,4,2.5,2380,13550,2.0,3,2380,0,98188
445000.0,3,2.5,2210,8010,2.0,3,2210,0,98045
336500.0,3,2.25,1420,3433,2.0,4,1420,0,98034
267000.0,3,2.5,1690,10336,2.0,4,1690,0,98010
545000.0,4,2.5,2040,7412,2.0,3,2040,0,98074
274950.0,3,1.75,1840,16679,1.0,3,1840,0,98001
420000.0,3,2.5,1470,1445,2.0,3,1160,310,98029
575950.0,3,2.25,1640,12000,1.0,3,1180,460,98008
180000.0,4,1.5,1740,7292,1.0,3,1020,720,98168
261350.0,3,1.75,1390,18200,1.0,4,1390,0,98023
390000.0,3,1.75,1435,8960,1.0,4,1435,0,98058
255000.0,4,2.5,1580,7800,1.0,4,1580,0,98059
257000.0,3,2.5,1740,3721,2.0,3,1740,0,98002
540000.0,3,2.5,1720,11656,2.0,3,1720,0,98052
280000.0,3,2.5,1600,4271,2.0,3,1600,0,98001
480000.0,3,2.5,1640,7847,2.0,3,1640,0,98029
440000.0,3,1.75,1500,6180,1.0,4,1060,440,98118
743700.0,4,2.5,2610,33206,2.0,3,2610,0,98053
449950.0,3,1.75,1470,7590,1.0,3,1470,0,98117
295000.0,3,2.5,1940,10350,1.0,3,1420,520,98001
207000.0,3,1.5,1460,11100,1.0,3,1460,0,98003
575000.0,3,2.5,1750,4797,2.0,4,1750,0,98033
468000.0,3,2.25,1630,2490,2.0,3,1630,0,98053
817000.0,4,2.25,2600,10660,2.0,4,2600,0,98006
525000.0,3,1.75,1470,6550,1.0,3,1070,400,98126
629950.0,3,2.5,1680,1683,2.0,3,1120,560,98119
490000.0,3,2.25,1630,7573,1.0,3,1230,400,98034
415000.0,3,1.75,1790,15142,1.0,3,1360,430,98072
300000.0,3,1.75,1450,7620,1.0,4,1050,400,98166
616000.0,3,1.5,1740,9840,1.0,4,1740,0,98040
245000.0,3,1.5,2100,10000,1.0,4,2100,0,98198
578000.0,3,1.5,1660,6000,1.5,3,1660,0,98199
575000.0,3,2.75,1710,3600,1.0,3,1590,120,98119
445000.0,4,2.25,2130,7200,2.0,3,2130,0,98034
598500.0,4,2.5,2520,3980,2.0,3,2520,0,98027
424950.0,4,2.5,2480,8563,2.0,3,2480,0,98038
399950.0,4,2.5,2350,5100,2.0,3,2350,0,98038
539000.0,3,2.0,2260,9568,1.0,3,1780,480,98074
544000.0,3,2.5,1460,1613,2.0,3,1180,280,98117
470000.0,3,2.0,1730,38884,1.0,3,1730,0,98038
200000.0,4,2.75,1910,7210,1.0,4,1430,480,98030
658100.0,4,2.5,2430,8509,2.0,3,2430,0,98029
305500.0,4,2.5,1850,7199,2.0,4,1850,0,98031
340000.0,3,2.25,2120,13090,1.0,3,2120,0,98002
269000.0,4,2.5,2060,3608,2.0,3,2060,0,98198
735000.0,4,1.75,2380,5700,2.0,4,1820,560,98105
619500.0,3,2.5,1700,4105,2.0,3,1700,0,98122
675000.0,3,1.75,1240,13869,1.0,4,1240,0,98033
627000.0,4,2.0,2030,9300,1.0,4,2030,0,98052
314500.0,3,1.75,1700,17355,1.0,3,1200,500,98038
444950.0,3,2.5,2020,7800,1.0,4,1330,690,98133
598000.0,4,2.5,2030,9825,1.0,3,1330,700,98115
595000.0,3,2.5,1750,3354,2.0,4,1750,0,98033
542500.0,4,2.5,2330,14289,2.0,4,2330,0,98007
450000.0,3,1.75,1720,6960,1.0,3,1140,580,98052
265000.0,3,2.5,1340,10290,1.0,4,1140,200,98042
324900.0,3,2.25,2080,9740,2.0,3,2080,0,98092
425000.0,4,1.5,1620,7875,1.0,3,1620,0,98008
187000.0,3,2.5,1730,1803,2.0,3,1730,0,98166
585000.0,3,1.75,1840,7350,1.0,3,1370,470,98033
250000.0,3,1.75,1780,35233,1.0,4,1420,360,98001
400000.0,4,2.0,2060,3060,2.0,3,2060,0,98118
435000.0,3,2.0,2040,6880,2.0,4,2040,0,98133
293000.0,4,2.25,1870,5371,2.0,3,1870,0,98038
592100.0,4,2.75,2310,7851,1.0,4,1790,520,98006
335500.0,3,1.75,1260,8487,1.0,3,1260,0,98011
445000.0,3,2.5,1740,22089,1.0,4,1130,610,98070
385000.0,3,2.25,1680,8450,1.0,3,1340,340,98177
345000.0,3,1.5,1240,11200,1.0,4,1240,0,98006
444500.0,3,2.5,2600,4724,2.0,3,2600,0,98065
461000.0,4,2.75,1700,7495,1.0,4,1200,500,98133
249000.0,3,1.5,1180,11579,1.0,4,1180,0,98058
269000.0,3,2.25,1950,8661,1.0,4,1950,0,98023
885000.0,3,2.25,2060,9552,1.0,4,1610,450,98040
455000.0,3,2.0,1640,9825,1.0,4,1090,550,98034
412500.0,3,1.75,1530,6300,1.0,3,1530,0,98126
568500.0,4,2.5,2460,4200,2.0,3,2460,0,98074
620000.0,4,2.5,2500,8282,2.0,3,2500,0,98056
283000.0,3,1.75,1830,7600,2.0,3,1490,340,98106
289950.0,3,2.5,2070,6145,2.0,3,2070,0,98092
252500.0,3,2.5,1780,7192,1.0,4,1250,530,98031
440000.0,3,1.75,1570,5120,1.0,3,980,590,98177
275000.0,4,2.0,1480,15000,1.0,4,1480,0,98055
229000.0,3,2.0,1760,9900,1.0,4,1760,0,98166
500000.0,4,2.25,2060,44431,2.0,3,2060,0,98077
369000.0,4,2.5,2370,6557,2.0,3,2370,0,98042
470000.0,3,2.5,1980,9725,2.0,3,1980,0,98045
675000.0,3,2.5,2540,7680,2.0,4,2540,0,98177
429950.0,3,2.25,2060,10160,1.0,4,1340,720,98155
225000.0,3,2.25,1590,9200,1.0,4,1110,480,98092
222500.0,3,2.0,1450,9044,2.0,3,1450,0,98022
467000.0,3,2.0,1840,3432,2.0,3,1840,0,98155
339000.0,3,2.25,1970,7210,1.0,4,1380,590,98030
440500.0,3,2.5,2460,4399,2.0,3,2460,0,98065
635000.0,3,1.75,1530,5000,1.0,3,1020,510,98117
245000.0,4,2.5,1700,4268,2.0,3,1700,0,98001
355500.0,3,2.5,2600,5540,2.0,3,2600,0,98038
324900.0,4,2.25,2010,7280,2.0,4,2010,0,98032
552321.0,3,2.5,1960,8469,2.0,4,1960,0,98052
237000.0,3,1.5,1800,9216,1.0,4,1800,0,98001
190500.0,3,2.0,1390,10155,1.0,3,1130,260,98003
500000.0,4,2.5,2040,6685,2.0,3,2040,0,98133
448000.0,4,2.5,2510,6853,2.0,3,2510,0,98038
399000.0,3,2.5,1800,3300,2.0,3,1690,110,98118
478000.0,3,1.75,1210,6175,1.0,3,1210,0,98034
430000.0,4,2.25,1790,7203,1.0,4,1110,680,98155
433000.0,4,1.5,1550,5053,1.0,4,1180,370,98118
347500.0,4,2.5,2460,7350,2.0,3,2460,0,98023
425000.0,3,1.75,1960,43332,1.0,4,1400,560,98077
429000.0,3,2.5,1920,15124,2.0,3,1920,0,98045
540000.0,3,2.25,1670,3135,2.0,3,1220,450,98199
221000.0,4,1.75,1540,7200,1.0,3,1260,280,98003
405000.0,3,2.0,1640,7201,1.0,3,1640,0,98125
588000.0,4,1.75,1930,7245,1.0,4,1510,420,98008
234950.0,3,2.0,1430,10850,1.0,3,1430,0,98001
580000.0,4,1.5,2430,4995,1.5,4,1730,700,98144
772000.0,4,2.5,2110,3750,2.0,3,2110,0,98117
423500.0,3,2.0,2000,10490,1.0,3,1430,570,98033
520000.0,3,1.5,1810,18483,1.0,3,1810,0,98177
795000.0,3,2.75,1820,7517,1.0,3,1820,0,98116
415000.0,4,2.5,2000,5962,2.0,3,2000,0,98133
442000.0,3,2.5,1980,39932,2.0,3,1980,0,98011
279000.0,3,2.5,2010,11618,2.0,3,2010,0,98022
468000.0,3,1.5,1370,7697,1.0,3,1370,0,98177
237100.0,3,1.75,1360,9603,1.0,3,1360,0,98198
336000.0,4,2.5,2530,8169,2.0,3,2530,0,98003
500000.0,4,2.0,1680,3813,2.0,4,1680,0,98144
290000.0,3,2.5,1580,6860,2.0,3,1580,0,98055
554000.0,3,1.75,1760,10780,1.0,3,1760,0,98005
424000.0,3,2.0,1670,7700,1.0,3,1170,500,98034
508500.0,4,1.5,1800,6750,1.5,4,1800,0,98115
244500.0,3,1.75,1210,8864,1.0,3,1210,0,98042
643500.0,3,2.0,1650,7104,2.0,3,1650,0,98177
372500.0,4,1.75,1590,10523,2.0,4,1590,0,98133
476000.0,3,1.75,1650,9600,1.0,4,1650,0,98075
277500.0,3,2.5,1690,5171,2.0,3,1690,0,98023
465000.0,4,2.25,2100,7350,2.0,3,2100,0,98033
450000.0,4,1.75,2190,9752,1.0,3,2190,0,98034
615000.0,3,2.25,2530,45234,2.0,4,2530,0,98072
437500.0,3,2.25,1970,35100,2.0,4,1970,0,98027
545000.0,3,1.75,1400,4000,1.5,4,1400,0,98117
560000.0,3,2.0,1860,13374,1.0,3,1860,0,98027
327000.0,3,1.5,1320,13200,1.0,3,1320,0,98059
273000.0,3,1.75,1540,10545,2.0,4,1540,0,98045
240000.0,3,1.5,1450,9477,1.0,4,1450,0,98031
400000.0,3,1.75,1830,9620,1.0,4,1830,0,98023
372000.0,4,2.5,2500,8215,2.0,3,2500,0,98031
459500.0,3,1.75,1470,4950,1.0,3,1030,440,98133
582000.0,3,2.5,2380,19860,2.0,4,2380,0,98056
386000.0,3,2.0,2120,7560,1.0,3,2120,0,98058
546000.0,3,2.5,1530,3464,2.0,3,1530,0,98007
278000.0,3,1.75,2710,9088,1.0,4,2060,650,98001
561600.0,4,2.5,2350,6624,2.0,3,2350,0,98074
620000.0,4,2.25,2210,8101,2.0,3,2210,0,98074
449000.0,4,2.75,2090,14141,1.5,4,1680,410,98166
299950.0,4,1.75,1560,31299,1.0,4,1560,0,98092
352500.0,4,2.0,1970,7451,1.0,3,1350,620,98133
305000.0,3,2.0,1830,10873,1.0,3,1830,0,98023
607500.0,3,1.5,1800,4700,1.0,3,1200,600,98117
425000.0,3,2.25,1580,39189,1.0,3,1180,400,98053
580000.0,4,2.25,2570,36465,2.0,4,2570,0,98053
546200.0,4,2.25,2090,8579,2.0,3,2090,0,98074
315000.0,3,1.75,1860,9629,1.0,4,1240,620,98059
379000.0,3,2.5,1500,7420,1.0,3,1000,500,98034
392000.0,3,2.25,1790,7125,1.0,3,1220,570,98034
465000.0,3,2.5,1650,4636,2.0,3,1650,0,98075
825000.0,4,2.75,2220,11925,1.0,3,1560,660,98004
337000.0,3,1.75,1440,11364,1.0,3,1440,0,98155
280000.0,3,2.5,1970,8426,2.0,3,1970,0,98003
202000.0,3,1.5,1420,9081,1.0,4,1420,0,98022
585000.0,4,2.5,2250,4119,2.0,3,2250,0,98075
515000.0,3,2.25,1640,8400,1.0,4,1640,0,98006
590000.0,4,2.5,2380,4950,2.0,3,2380,0,98136
490000.0,3,2.25,2330,3600,1.5,3,2330,0,98074
277000.0,3,2.25,2160,9612,2.0,3,2160,0,98022
649800.0,4,2.5,2280,9827,2.0,3,2280,0,98033
407500.0,3,2.5,1930,10460,2.0,3,1930,0,98059
264950.0,4,2.5,1990,9656,2.0,3,1990,0,98010
547500.0,3,2.5,2550,10355,2.0,3,2550,0,98011
264500.0,3,2.25,1370,7087,2.0,3,1370,0,98038
315000.0,4,2.5,2080,5650,1.0,3,1680,400,98178
320000.0,4,2.5,2070,7007,2.0,3,2070,0,98031
760000.0,3,2.5,2190,10000,1.0,4,1540,650,98040
470000.0,4,2.0,2180,17180,2.0,4,2180,0,98014
457000.0,3,1.75,1690,6375,1.0,3,1690,0,98024
635000.0,3,2.5,1780,11000,1.0,4,1210,570,98006
350500.0,3,2.25,1870,7200,1.0,3,1390,480,98072
550000.0,3,2.25,1850,37264,2.0,3,1850,0,98053
240000.0,3,2.0,1190,10299,1.0,3,1190,0,98010
615000.0,4,1.75,2300,11700,1.0,4,1960,340,98052
284000.0,3,1.5,1500,10018,1.0,4,1500,0,98058
645000.0,3,2.5,2490,5978,2.0,3,2490,0,98074
218000.0,3,1.5,1330,7600,1.0,4,1330,0,98023
575000.0,3,2.5,1590,2910,2.0,3,1110,480,98115
626000.0,3,2.25,1810,5107,2.0,3,1810,0,98033
325000.0,4,2.5,2160,6825,2.0,3,2160,0,98031
720000.0,3,2.5,2100,2200,2.0,4,1500,600,98122
465000.0,3,1.75,1410,6886,1.0,3,1410,0,98133
225000.0,3,1.75,1350,9793,1.0,4,1350,0,98022
499000.0,3,1.75,2650,11774,1.0,3,2240,410,98146
580000.0,3,2.5,2040,4627,2.0,3,2040,0,98052
730000.0,4,1.5,2340,5000,2.0,3,2100,240,98122
325000.0,4,2.25,1770,7799,2.0,3,1770,0,98031
316000.0,3,2.5,1490,4078,2.0,3,1490,0,98059
401000.0,3,2.25,1350,2839,2.0,3,1350,0,98053
539950.0,3,1.75,1820,9875,1.0,4,1820,0,98008
335000.0,3,2.0,1170,5360,1.0,3,1170,0,98106
339000.0,3,2.5,1450,3748,2.0,3,1450,0,98065
650000.0,4,2.0,1610,8976,1.0,4,1610,0,98004
295000.0,3,2.25,1850,7800,2.0,3,1850,0,98023
296500.0,3,1.5,1580,10100,1.0,4,1580,0,98055
440000.0,4,2.75,2030,56192,1.0,3,1550,480,98077
302000.0,3,2.5,2140,9492,2.0,3,2140,0,98092
350000.0,4,1.75,1770,7336,1.0,4,1770,0,98058
430000.0,4,2.75,1820,5400,1.0,4,1220,600,98056
495000.0,3,2.25,1780,8050,1.0,4,1230,550,98052
500000.0,4,2.5,1900,5001,1.0,3,1200,700,98133
298000.0,3,1.75,1620,12825,1.0,3,1340,280,98003
290000.0,3,2.0,1360,6685,1.0,3,1360,0,98155
482000.0,3,2.25,1710,21485,2.0,3,1710,0,98074
488000.0,3,1.75,2180,14734,2.0,3,2180,0,98045
357000.0,3,1.5,1590,6750,1.0,3,1080,510,98034
583000.0,3,2.25,1830,8276,1.0,3,1350,480,98074
173250.0,3,2.0,1210,9097,1.0,4,1210,0,98168
414050.0,4,2.0,1590,10331,1.5,4,1590,0,98133
537000.0,3,2.0,1550,27003,1.5,3,1550,0,98074
465000.0,4,2.25,2070,7500,2.0,4,2070,0,98034
445000.0,4,2.0,1700,21780,1.0,4,1080,620,98052
275000.0,3,2.5,1710,7230,2.0,3,1710,0,98003
190000.0,4,2.5,1840,13493,2.0,3,1840,0,98001
385000.0,3,1.75,1900,5520,1.0,3,1280,620,98118
269950.0,3,2.5,1480,9743,2.0,4,1480,0,98010
670500.0,4,2.0,1590,6750,1.0,3,1590,0,98102
420000.0,4,1.5,1690,9391,1.0,3,1290,400,98155
360000.0,3,1.75,1500,7200,1.0,3,1500,0,98133
562500.0,4,2.5,2320,8721,2.0,3,2320,0,98034
389999.0,3,2.25,1445,1471,2.0,3,1300,145,98027
247500.0,4,2.0,1760,8400,1.0,3,1060,700,98003
455000.0,3,2.5,1980,7309,2.0,3,1980,0,98034
314000.0,4,2.5,2340,8990,2.0,3,2340,0,98038
550000.0,3,1.75,1440,8957,1.0,4,1440,0,98008
530000.0,4,2.25,1980,15086,2.0,3,1980,0,98074
637500.0,3,1.75,1680,10685,1.0,4,1680,0,98033
400000.0,3,2.5,1390,2815,2.0,3,1390,0,98126
272000.0,3,2.5,1680,8512,2.0,3,1680,0,98022
550000.0,3,2.25,2090,8095,2.0,3,2090,0,98136
406000.0,3,1.75,1270,6017,1.0,4,1030,240,98028
469000.0,3,1.75,1680,2400,1.5,3,1170,510,98117
415000.0,3,2.5,2090,6045,2.0,3,2090,0,98056
251000.0,3,1.75,1350,10125,1.0,3,1350,0,98003
845000.0,4,2.5,2390,5071,2.0,3,1760,630,98122
350000.0,3,1.5,1860,17640,1.0,4,1860,0,98059
503000.0,3,1.75,2070,9827,1.0,4,1420,650,98027
250000.0,3,1.75,1910,10230,1.0,4,1290,620,98031
268500.0,4,2.5,2100,4237,2.0,3,2100,0,98031
295000.0,4,2.5,2290,4539,2.0,3,2290,0,98058
780000.0,3,2.25,2130,11782,1.0,4,1590,540,98040
354000.0,3,2.5,2160,15817,2.0,3,2160,0,98031
640000.0,4,2.75,2100,11894,1.0,4,1720,380,98004
840000.0,4,2.5,2360,9600,1.0,3,1630,730,98040
625000.0,4,2.75,1680,11180,1.0,4,1680,0,98052
500000.0,4,1.5,1330,5750,1.5,3,1330,0,98116
540000.0,4,1.75,2040,9322,1.0,3,1440,600,98155
712000.0,3,2.5,2375,4094,2.0,3,2375,0,98052
425000.0,4,2.5,2480,4504,2.0,3,2480,0,98059
415000.0,4,1.75,1920,7700,2.0,4,1920,0,98056
375000.0,3,2.75,2200,9600,1.0,4,1570,630,98003
310000.0,3,1.5,1860,10379,1.0,3,1240,620,98198
360000.0,3,1.75,1510,6000,1.0,3,1060,450,98136
342000.0,4,2.25,1964,3541,2.0,3,1964,0,98030
413000.0,3,2.0,1520,3451,1.0,3,1520,0,98177
280000.0,3,1.5,1430,8861,1.0,3,1430,0,98188
500000.0,3,2.5,1670,2575,2.0,3,1670,0,98027
294999.0,4,2.5,1660,9760,2.0,3,1660,0,98030
175000.0,3,1.75,1910,17003,1.5,4,1910,0,98001
299000.0,3,1.75,1910,17003,1.5,4,1910,0,98001
290000.0,3,2.25,1650,10336,1.0,3,1500,150,98133
334999.0,3,2.5,1650,13816,2.0,3,1650,0,98014
297950.0,3,2.0,1240,10800,1.0,3,1240,0,98058
204250.0,3,2.25,1960,7708,1.0,4,1490,470,98023
500000.0,3,2.25,1710,4561,2.0,4,1710,0,98029
405000.0,4,2.5,2670,20894,2.0,3,2330,340,98155
385000.0,3,2.25,1710,11500,1.0,3,1210,500,98028
560000.0,4,2.5,2280,9874,2.0,3,2280,0,98034
231000.0,3,2.0,1640,4875,1.0,4,1040,600,98042
642000.0,4,2.5,2560,8780,2.0,3,2560,0,98029
250000.0,3,2.5,1730,7200,2.0,4,1730,0,98031
325000.0,4,2.25,1870,9680,1.0,4,1170,700,98034
399950.0,3,2.5,2570,10431,2.0,3,2570,0,98031
400000.0,4,1.5,2150,11026,1.0,4,2150,0,98028
286000.0,3,2.5,1680,4226,2.0,3,1680,0,98042
531800.0,3,2.5,1930,5344,2.0,3,1930,0,98053
502000.0,4,2.25,2140,10943,1.0,3,1550,590,98034
305000.0,3,2.0,1490,7697,1.0,3,1490,0,98059
525000.0,3,1.75,1330,8136,1.0,4,1330,0,98033
695000.0,3,2.75,2590,12063,2.0,3,2590,0,98006
796500.0,3,2.75,2590,12063,2.0,3,2590,0,98006
620000.0,3,1.75,1670,9900,1.0,4,1670,0,98005
275000.0,4,2.0,1440,10920,1.0,3,1440,0,98056
197000.0,3,1.75,1690,7735,1.0,4,1060,630,98001
265000.0,3,1.75,1420,8126,1.0,3,1420,0,98031
207500.0,3,1.75,1320,12528,1.0,4,1320,0,98042
268000.0,3,2.0,1610,8416,1.0,3,1610,0,98031
330000.0,4,1.75,1550,50094,1.0,4,1550,0,98022
760000.0,4,2.25,2500,8500,2.0,4,2500,0,98006
620000.0,4,2.5,1910,7683,2.0,3,1910,0,98027
315000.0,3,2.5,2340,6837,2.0,3,2340,0,98030
624950.0,3,2.5,2060,4730,2.0,4,2060,0,98033
525000.0,3,2.25,1960,12350,1.0,4,1960,0,98027
629950.0,3,2.5,1680,1683,2.0,3,1120,560,98119
500000.0,4,2.25,2420,36680,2.0,4,2420,0,98027
506500.0,4,2.5,1890,7200,1.0,4,1500,390,98034
500000.0,3,2.25,1760,4539,2.0,3,1760,0,98029
308000.0,3,1.75,1630,11475,1.0,4,1330,300,98045
613500.0,3,2.5,2350,7035,2.0,3,2350,0,98029
255000.0,3,1.75,1550,9720,1.0,3,1050,500,98010
450000.0,3,1.75,1740,6800,1.5,4,1740,0,98126
625000.0,3,2.5,2010,3200,2.0,3,2010,0,98027
274950.0,3,1.75,1670,7415,1.0,3,1320,350,98042
232000.0,3,1.75,1290,6604,1.0,3,1290,0,98023
220000.0,3,1.75,1230,8917,1.0,4,1230,0,98058
640000.0,4,2.5,2210,7722,2.0,3,2210,0,98075
380000.0,4,2.5,2270,11500,1.0,3,1540,730,98034
624900.0,4,2.5,2270,11500,1.0,3,1540,730,98034
379770.0,3,2.5,1470,1779,2.0,3,1160,310,98029
340000.0,3,1.75,1280,16200,1.0,3,1030,250,98077
600000.0,4,2.25,1970,7125,1.5,3,1500,470,98115
440000.0,4,2.5,2250,7526,2.0,3,2250,0,98059
518000.0,4,2.5,2070,10244,1.0,3,1370,700,98006
265950.0,3,2.5,1490,3840,2.0,3,1490,0,98042
578550.0,3,2.5,2120,6602,2.0,4,2120,0,98029
451000.0,4,2.5,1670,3315,2.0,3,1670,0,98029
485000.0,3,2.0,1420,4080,1.5,3,1420,0,98103
530000.0,3,2.75,2440,45738,2.0,3,1840,600,98027
379000.0,4,2.5,2570,10155,2.0,3,2570,0,98030
543500.0,4,2.5,2550,5835,2.0,3,2550,0,98065
376000.0,4,2.75,2420,5773,2.0,3,2420,0,98038
430000.0,3,2.25,1470,1703,2.0,3,1470,0,98029
515000.0,4,2.5,2030,39049,1.0,4,1530,500,98166
476800.0,3,1.75,1900,43700,1.5,4,1900,0,98052
815000.0,3,1.5,1940,3570,2.0,4,1740,200,98105
455600.0,3,2.5,2420,8252,2.0,3,2420,0,98065
242000.0,3,1.75,1310,9645,1.0,3,1310,0,98198
475000.0,3,2.75,1890,3938,2.0,3,1890,0,98065
725000.0,3,1.75,1530,4000,2.0,3,1530,0,98136
438000.0,3,2.5,1650,3031,2.0,3,1650,0,98053
425500.0,3,2.5,1970,2752,2.0,3,1970,0,98052
418500.0,3,2.5,2060,4399,2.0,3,2060,0,98065
826000.0,3,1.5,1890,5000,1.5,3,1890,0,98109
421200.0,3,2.5,1440,3060,2.0,3,1440,0,98053
842500.0,3,2.25,2560,3996,1.5,3,2150,410,98112
310000.0,3,2.5,1890,6300,2.0,3,1890,0,98038
335000.0,4,2.25,2160,8817,1.0,3,1460,700,98133
499950.0,4,2.25,2160,8817,1.0,3,1460,700,98133
525000.0,3,2.5,2320,9610,1.0,3,1730,590,98011
440000.0,3,2.0,1790,32379,1.0,3,1790,0,98045
780000.0,3,2.25,2140,3000,2.0,3,2140,0,98103
855000.0,3,1.75,1900,4000,1.0,3,1300,600,98103
225000.0,3,2.25,1650,7739,1.0,3,1290,360,98003
390000.0,3,2.25,1600,10240,1.0,3,1090,510,98034
425000.0,3,2.5,1800,14036,2.0,3,1800,0,98019
269000.0,3,1.5,1320,2625,2.0,3,1320,0,98133
302000.0,4,2.75,2030,9120,1.0,4,2030,0,98003
565000.0,4,2.0,2040,8281,2.0,3,2040,0,98033
345000.0,3,1.5,1390,13860,2.0,3,1390,0,98045
364950.0,4,2.5,2070,2992,2.0,3,2070,0,98058
231000.0,3,1.75,1220,8817,1.0,3,1220,0,98023
445000.0,3,2.0,1630,8702,1.0,3,1630,0,98056
209950.0,3,1.5,1380,11130,1.0,3,1380,0,98003
257000.0,3,2.25,1730,9516,1.0,3,1180,550,98030
337000.0,4,2.5,2230,5970,2.0,4,2230,0,98042
541000.0,3,2.5,1790,4038,2.0,3,1790,0,98029
577500.0,3,2.5,2280,10879,2.0,3,2280,0,98074
715000.0,4,2.5,1860,3840,1.5,3,1170,690,98117
465000.0,4,2.5,1930,9653,1.0,4,1930,0,98023
287600.0,3,2.5,1950,8251,2.0,3,1950,0,98001
445000.0,3,2.25,1630,6449,1.0,3,1310,320,98011
490000.0,4,2.25,2110,16200,1.0,3,1630,480,98072
565000.0,3,1.75,1490,5000,1.0,3,1250,240,98136
330000.0,3,2.5,1740,1844,2.0,3,1320,420,98106
463000.0,4,2.75,1900,6000,1.0,3,1300,600,98178
622200.0,3,1.75,1720,7200,1.0,3,1420,300,98125
389950.0,3,1.75,1580,9049,1.0,3,1580,0,98177
304500.0,4,2.5,2030,5202,2.0,3,2030,0,98031
710000.0,3,2.5,2330,9160,2.0,3,2330,0,98006
540000.0,3,2.5,2600,23361,1.5,3,2150,450,98146
284000.0,3,1.75,1800,23103,1.0,3,1800,0,98014
440000.0,4,1.75,2180,10200,1.0,3,2000,180,98028
405000.0,3,2.5,1430,10200,1.0,3,1430,0,98033
339900.0,4,2.5,2340,9748,1.0,3,1610,730,98003
258000.0,3,2.0,1790,7879,1.5,3,1790,0,98001
500000.0,3,2.5,2300,4307,2.0,3,2300,0,98034
248500.0,3,2.5,1360,7293,2.0,3,1360,0,98003
665000.0,4,2.5,2510,5936,2.0,3,2510,0,98075
220000.0,3,2.0,1410,7998,1.0,4,1410,0,98178
631500.0,4,2.0,2530,5650,1.5,4,1910,620,98116
380000.0,3,1.75,1240,8611,1.0,4,1240,0,98133
594000.0,4,1.75,1870,5200,2.0,4,1200,670,98115
500000.0,4,2.25,2050,7201,2.0,3,2050,0,98033
220000.0,3,1.5,1660,15600,2.0,3,1660,0,98001
179900.0,3,1.75,1230,12000,1.0,3,1230,0,98001
490000.0,4,2.5,2360,4367,2.0,3,2360,0,98011
447500.0,4,2.0,1770,3332,2.0,3,1630,140,98118
415000.0,4,1.5,1540,7886,2.0,3,1540,0,98034
500000.0,3,2.25,1580,4379,2.0,4,1580,0,98029
419950.0,4,2.5,2220,6800,2.0,3,2220,0,98059
330000.0,3,1.5,1170,4950,1.0,4,1170,0,98007
515000.0,3,2.5,2100,7851,2.0,3,2100,0,98052
665000.0,4,2.5,2600,17388,2.0,3,2600,0,98059
265000.0,3,1.75,1630,5999,1.5,4,1630,0,98198
545400.0,3,2.0,2850,19200,1.0,3,2340,510,98023
355000.0,3,2.0,2160,8091,1.5,3,2160,0,98003
316000.0,3,2.25,1900,7479,2.0,4,1900,0,98038
312900.0,4,2.5,1630,4473,2.0,3,1630,0,98038
475000.0,3,2.5,1800,3300,2.0,3,1690,110,98118
415000.0,3,2.25,1820,9694,1.0,3,1240,580,98074
406500.0,3,2.0,1780,8621,1.0,3,1780,0,98059
407193.0,4,2.0,1880,14653,2.0,3,1880,0,98014
535000.0,4,2.5,2340,5600,2.0,3,2340,0,98146
337000.0,3,1.75,1310,12750,1.0,3,1310,0,98059
630000.0,3,2.0,1470,6000,1.0,3,1090,380,98033
320000.0,3,1.75,1370,9900,1.0,4,1370,0,98003
293000.0,3,2.5,1990,7577,2.0,3,1990,0,98023
226500.0,3,1.75,1640,10762,1.0,3,1130,510,98042
436000.0,3,2.25,1770,8000,1.0,4,1350,420,98072
451000.0,3,2.5,2050,4876,2.0,3,2050,0,98072
329900.0,3,2.5,2170,4905,2.0,3,2170,0,98038
725000.0,3,1.75,1880,13300,1.0,3,1380,500,98004
280000.0,3,2.5,1610,10022,2.0,3,1610,0,98003
605004.0,4,2.0,1370,4000,2.0,3,1370,0,98199
418000.0,3,1.75,1670,12075,1.0,3,1370,300,98155
390000.0,3,2.0,1930,12443,1.0,3,1930,0,98045
700000.0,3,1.75,1350,4000,1.5,4,1350,0,98103
496600.0,3,2.5,1910,5562,2.0,3,1910,0,98029
246000.0,3,2.25,1440,10500,1.0,3,1130,310,98023
585000.0,3,2.0,1670,4572,1.5,3,1670,0,98117
450000.0,3,1.75,1390,11700,1.0,4,1390,0,98033
266500.0,3,2.25,1740,5460,1.0,3,1210,530,98038
243500.0,4,2.0,1610,6200,1.0,4,1610,0,98198
315000.0,3,2.75,1780,15114,1.0,3,1080,700,98003
465000.0,3,2.0,1430,14250,1.0,3,1430,0,98033
465000.0,3,2.25,1840,5752,2.0,3,1840,0,98034
505000.0,3,2.5,1820,11012,2.0,3,1820,0,98074
690000.0,3,1.75,2330,16300,2.0,3,2330,0,98034
500000.0,4,2.25,1960,12436,2.0,3,1960,0,98074
479000.0,3,2.5,1690,3322,2.0,3,1690,0,98053
612500.0,4,2.5,2550,10623,2.0,3,2550,0,98029
295000.0,3,2.5,1690,8564,2.0,4,1690,0,98038
275250.0,3,2.25,1520,7199,2.0,4,1520,0,98038
250000.0,4,2.5,2040,5770,2.0,3,2040,0,98038
709000.0,3,2.0,2360,18000,1.0,4,2180,180,98177
399500.0,4,1.75,1360,4840,1.5,4,1360,0,98126
225000.0,3,2.5,2000,9202,2.0,4,2000,0,98038
500000.0,3,2.5,1650,4648,2.0,3,1650,0,98075
616750.0,3,1.5,2140,47743,1.5,3,2140,0,98106
605000.0,3,2.25,1960,10139,2.0,3,1960,0,98074
590000.0,3,2.25,2490,8800,2.0,4,2490,0,98006
242000.0,3,1.75,1500,7560,1.0,3,1500,0,98003
217000.0,3,2.5,1340,4200,2.0,3,1340,0,98002
395000.0,3,2.5,1960,3953,2.0,3,1960,0,98059
572500.0,3,2.25,2030,9791,1.0,4,1500,530,98059
241000.0,3,2.0,1520,7131,1.0,3,1520,0,98023
475000.0,3,1.75,1340,2805,1.5,3,1340,0,98144
475000.0,4,1.5,1580,10260,1.0,4,1030,550,98007
425000.0,3,2.25,1890,8400,1.0,3,1520,370,98034
565000.0,4,2.0,1710,3875,1.5,4,1710,0,98122
263000.0,3,1.75,1790,7485,1.0,4,1330,460,98023
375000.0,4,1.75,1680,6834,1.5,3,1680,0,98125
272450.0,3,2.25,1780,7332,2.0,3,1780,0,98038
427000.0,4,1.75,1460,9750,1.0,4,1460,0,98008
765000.0,3,1.75,2190,6450,1.0,3,1480,710,98136
445000.0,4,2.5,2790,8111,2.0,3,2480,310,98058
345000.0,4,2.5,2040,5523,2.0,3,2040,0,98148
270000.0,3,2.0,1690,9583,1.0,4,1690,0,98059
520000.0,3,1.75,1490,1036,2.0,3,1090,400,98199
253500.0,3,1.5,1440,12040,1.0,4,1440,0,98042
475000.0,3,1.5,1750,12632,1.0,4,1750,0,98033
390000.0,4,2.5,1940,3864,2.0,3,1940,0,98058
296500.0,3,2.5,1770,6033,2.0,4,1770,0,98042
895000.0,4,2.0,1710,4178,1.5,4,1710,0,98112
389000.0,4,2.5,2420,9147,2.0,3,2420,0,98003
508450.0,4,1.75,1520,9600,1.0,4,1000,520,98006
705000.0,3,2.0,1460,6250,1.5,4,1460,0,98103
539900.0,3,2.5,2500,4203,2.0,3,2500,0,98065
315000.0,3,2.0,1220,14645,1.0,3,1220,0,98059
744000.0,3,2.5,2020,7512,2.0,4,2020,0,98033
334500.0,3,2.5,1990,3694,2.0,3,1990,0,98042
600000.0,4,2.5,2360,13500,1.0,4,1780,580,98052
550000.0,3,1.75,1360,5850,1.0,4,1000,360,98116
245000.0,3,1.5,1260,7964,1.0,4,1260,0,98148
579000.0,3,1.75,1800,4429,2.0,4,1800,0,98103
339275.0,3,1.5,1590,7260,1.0,3,1080,510,98133
600000.0,3,2.25,1480,5400,2.0,4,1480,0,98122
245000.0,3,2.25,1780,9598,2.0,4,1780,0,98030
638150.0,4,2.5,2170,7275,1.0,3,1820,350,98027
480000.0,3,2.25,1820,13362,1.0,3,1220,600,98075
515000.0,3,2.25,1820,13362,1.0,3,1220,600,98075
718000.0,3,1.75,2280,3446,2.0,3,2280,0,98125
295000.0,3,2.25,1980,8000,1.0,4,1560,420,98023
675000.0,4,2.5,2390,5249,2.0,3,2390,0,98074
752888.0,3,2.5,2420,9000,2.0,4,2420,0,98007
335000.0,4,2.5,2370,6000,2.0,3,2370,0,98030
278000.0,4,2.25,2400,7738,1.5,3,2400,0,98148
334200.0,3,1.75,1410,45302,1.0,3,1410,0,98019
540000.0,4,1.75,1720,4240,1.5,4,1460,260,98144
560000.0,3,1.75,1570,4375,1.0,3,970,600,98116
440000.0,3,1.75,1550,7820,1.0,4,1210,340,98034
625000.0,3,2.5,2360,12164,2.0,3,2360,0,98029
680000.0,3,1.75,1760,8400,1.0,4,1460,300,98136
715000.0,4,2.25,1900,8272,1.0,4,1460,440,98040
291750.0,3,2.25,1310,12825,1.0,3,1310,0,98166
227000.0,3,1.75,1680,7455,1.0,4,1680,0,98023
675000.0,3,2.25,2260,13209,1.0,3,2260,0,98005
397500.0,3,2.25,1350,980,2.0,3,1050,300,98144
427500.0,4,2.5,2430,3249,2.0,3,2430,0,98059
550000.0,4,1.75,2550,39460,1.0,3,1890,660,98072
428000.0,3,2.5,2340,3466,2.0,3,2340,0,98065
390000.0,4,2.5,2560,43560,2.0,3,2560,0,98038
287000.0,4,2.25,2270,11997,1.0,4,1540,730,98198
424000.0,3,2.0,1330,5632,1.0,3,1330,0,98029
610000.0,4,2.5,2110,6360,2.0,3,2110,0,98029
330000.0,3,2.0,1500,11233,1.0,3,1500,0,98019
289000.0,3,1.75,1690,3449,1.0,3,1690,0,98055
400000.0,4,2.0,2680,13680,2.0,4,2350,330,98056
342000.0,3,2.5,1740,2226,2.0,3,1320,420,98106
239900.0,4,1.75,1570,18730,1.0,3,1200,370,98198
437000.0,3,1.75,2220,17568,1.0,4,2220,0,98072
525000.0,3,1.75,1710,7350,1.0,3,1280,430,98033
450000.0,3,2.75,2840,39324,1.0,3,2200,640,98092
560000.0,4,2.5,2300,7989,2.0,3,2300,0,98074
440000.0,3,2.5,2290,6302,2.0,3,2290,0,98058
430000.0,3,2.25,2160,6527,2.0,4,1580,580,98034
575000.0,3,1.75,2270,10136,2.0,3,2270,0,98027
400000.0,3,1.5,1200,4800,1.0,4,1200,0,98007
440000.0,4,2.5,2400,8038,2.0,3,2400,0,98059
298000.0,4,2.5,1960,11798,2.0,3,1960,0,98092
300000.0,4,1.75,1890,9205,1.0,3,1260,630,98133
310000.0,3,2.25,1590,3056,2.0,3,1590,0,98108
500000.0,4,2.5,2590,9354,2.0,4,2590,0,98011
343000.0,3,2.5,1270,2509,2.0,3,1270,0,98106
410000.0,3,2.5,1860,15457,2.0,3,1860,0,98019
630000.0,3,2.5,2320,32772,2.0,3,2320,0,98053
212000.0,3,1.5,1830,12233,1.5,4,1830,0,98022
275000.0,3,1.75,1580,8775,1.0,3,1220,360,98146
550000.0,3,2.75,2330,4780,2.0,3,1730,600,98198
255000.0,3,2.75,1900,16117,1.0,4,1900,0,98001
315000.0,3,2.5,1600,7982,2.0,3,1600,0,98001
575000.0,3,2.0,1520,5000,1.5,3,1140,380,98107
285500.0,4,1.75,1960,7950,1.0,4,1960,0,98023
326995.0,3,2.5,1860,5321,2.0,3,1860,0,98038
372500.0,4,2.25,1920,9660,1.0,4,1920,0,98058
400000.0,3,1.5,2390,32109,1.0,3,2390,0,98092
625000.0,3,2.0,1880,4000,1.0,3,1280,600,98199
304950.0,3,1.75,1350,9000,1.0,3,1350,0,98045
410000.0,4,2.5,1900,15123,2.0,3,1900,0,98045
457000.0,3,2.5,2050,5694,2.0,3,2050,0,98065
210000.0,3,1.5,1250,9484,1.0,4,1250,0,98042
259000.0,4,1.5,1810,9000,1.5,3,1810,0,98168
427000.0,3,1.75,1680,8610,1.0,4,1290,390,98034
363000.0,3,2.5,2390,8000,2.0,3,2390,0,98042
380000.0,4,1.75,1790,10186,1.0,4,1790,0,98177
580000.0,3,1.75,1570,2600,1.5,4,1570,0,98117
207200.0,4,2.0,1260,8400,1.0,3,1260,0,98022
525000.0,3,2.0,1790,11430,1.0,3,1190,600,98074
455000.0,4,2.5,1780,2992,2.0,3,1780,0,98072
343500.0,3,2.5,1900,5194,2.0,3,1900,0,98058
310000.0,3,2.75,2150,6576,1.0,4,1900,250,98155
279950.0,3,1.75,1930,7267,1.0,4,1330,600,98002
689000.0,3,2.5,2080,9612,1.0,4,1700,380,98125
620000.0,3,2.5,2590,7237,2.0,3,2590,0,98125
290000.0,3,2.5,1190,8175,1.0,3,1190,0,98055
645000.0,4,2.5,2340,8955,2.0,3,2340,0,98074
243000.0,3,1.75,1320,10416,1.0,3,1320,0,98031
292000.0,3,2.5,1600,3580,2.0,3,1600,0,98178
271500.0,3,2.5,1490,8005,1.0,3,1090,400,98058
382880.0,3,2.0,1620,9566,1.0,4,1620,0,98059
475000.0,3,1.5,1240,8738,1.0,3,1240,0,98005
330000.0,4,1.5,1890,7540,1.0,4,1890,0,98155
473000.0,3,2.25,1890,12236,1.0,3,1890,0,98074
550000.0,3,1.5,2440,7200,1.0,3,2440,0,98118
449500.0,3,2.25,1780,7280,1.0,3,1340,440,98034
511100.0,4,2.5,1560,12220,1.5,4,1560,0,98027
317950.0,3,2.5,1980,4500,2.0,3,1980,0,98042
542950.0,3,2.5,2070,39768,2.0,3,2070,0,98077
490000.0,3,1.75,1490,11360,1.0,3,1490,0,98008
475000.0,3,2.25,1580,8659,1.0,4,1220,360,98011
399000.0,3,2.5,1740,3690,2.0,3,1740,0,98065
412000.0,3,1.5,1320,8000,1.0,3,1320,0,98008
725000.0,4,2.25,2880,8882,2.0,4,2480,400,98115
315000.0,4,2.25,2550,9736,1.0,4,2550,0,98002
262500.0,4,2.0,1540,5110,1.0,3,1540,0,98118
660000.0,3,2.25,2280,6150,2.0,3,2280,0,98136
340000.0,4,2.5,2450,6941,2.0,3,2450,0,98042
417000.0,3,2.25,1840,11403,2.0,3,1840,0,98045
550000.0,4,2.0,1720,4000,1.0,3,1420,300,98105
369300.0,3,1.5,1480,21320,1.0,4,1480,0,98027
542500.0,3,2.5,2040,10086,2.0,3,2040,0,98052
368000.0,3,1.75,1750,14400,1.0,4,1750,0,98166
343500.0,3,2.0,1660,7509,1.0,3,1660,0,98059
400000.0,3,2.0,1170,3868,1.5,4,1170,0,98118
450000.0,3,2.5,2530,8116,2.0,3,2530,0,98011
488000.0,3,2.5,1940,5660,2.0,3,1940,0,98072
355000.0,3,2.5,2400,9701,1.0,3,2400,0,98023
255950.0,3,2.5,1720,3676,2.0,3,1720,0,98031
475000.0,3,1.5,1930,11092,1.0,3,1500,430,98074
315000.0,3,1.75,1970,8200,1.0,3,1270,700,98168
330950.0,3,2.5,1630,2844,2.0,3,1630,0,98118
312000.0,4,2.0,1890,8362,1.0,3,1890,0,98188
305000.0,3,2.25,1370,6600,2.0,4,1370,0,98038
270000.0,3,2.5,1770,7336,2.0,3,1770,0,98030
459800.0,3,2.0,1690,16061,1.0,3,1690,0,98074
451000.0,4,1.75,1680,7800,1.0,3,1330,350,98008
235000.0,4,1.5,1920,11595,1.0,4,1920,0,98002
383000.0,3,1.5,1340,7725,1.0,4,1340,0,98056
591000.0,3,2.0,1460,3600,2.0,3,1460,0,98122
476000.0,3,2.5,1440,3840,2.0,3,1440,0,98053
270000.0,3,2.25,1810,8262,2.0,4,1810,0,98023
740000.0,3,2.5,2710,18480,2.0,3,2000,710,98034
498000.0,3,2.5,1690,4088,2.0,3,1690,0,98053
339900.0,3,2.5,1470,4675,2.0,3,1470,0,98065
330000.0,3,2.25,1340,4080,1.5,3,1170,170,98144
490000.0,3,2.75,1990,31200,1.0,3,1990,0,98029
385000.0,4,2.5,2030,11375,1.0,3,1330,700,98028
230000.0,3,2.25,1830,11331,1.0,3,1250,580,98001
449000.0,4,2.5,1980,5400,2.0,3,1980,0,98056
318989.0,4,2.25,2000,9000,1.0,4,2000,0,98023
445000.0,3,1.5,1310,1266,2.0,3,1120,190,98116
330000.0,3,2.5,2370,9102,2.0,3,2370,0,98023
476500.0,4,2.5,2250,50155,2.0,3,2250,0,98045
556000.0,3,2.25,2020,3600,2.0,3,2020,0,98033
405000.0,3,2.0,1450,6081,1.0,4,1450,0,98155
259000.0,3,2.0,1610,14046,2.0,3,1610,0,98028
518000.0,3,2.5,1680,2096,2.0,3,1380,300,98117
549900.0,3,1.5,1380,3031,1.5,4,1380,0,98117
445000.0,3,1.75,1850,16863,1.0,4,1280,570,98034
559000.0,3,2.5,2010,5200,2.0,3,2010,0,98034
625000.0,4,2.5,1750,9000,1.0,3,1410,340,98052
430000.0,4,1.5,1560,6534,1.0,4,1560,0,98007
539950.0,3,2.0,1560,3200,1.5,3,1560,0,98109
255000.0,3,2.0,1490,7599,1.0,3,1490,0,98042
560000.0,4,2.5,2260,3713,2.0,3,2260,0,98034
475000.0,3,1.75,1550,4054,1.5,4,1550,0,98115
372000.0,3,2.5,2430,5000,2.0,3,2430,0,98042
442200.0,4,1.75,1620,8132,1.0,3,1620,0,98052
330000.0,4,2.5,2510,8580,2.0,4,2510,0,98023
280000.0,3,2.0,1640,13249,1.0,3,1640,0,98032
345000.0,3,2.5,1870,3584,2.0,3,1870,0,98058
685000.0,3,1.5,2230,8558,2.0,3,2230,0,98040
273148.0,3,1.75,1710,7210,1.0,4,1240,470,98031
246500.0,3,2.5,1620,7686,2.0,3,1620,0,98038
299950.0,4,2.5,1900,4054,2.0,3,1900,0,98042
260000.0,3,1.75,1670,8511,1.0,3,1340,330,98001
343000.0,4,2.5,2070,4500,2.0,3,2070,0,98038
290000.0,3,2.5,1600,6848,2.0,3,1600,0,98001
323000.0,3,1.5,1720,7110,1.0,3,1720,0,98106
419995.0,3,2.25,1830,7500,1.0,4,1330,500,98155
455000.0,3,2.5,1600,7829,2.0,3,1600,0,98034
718500.0,3,1.5,1200,6240,1.0,3,1030,170,98112
615750.0,4,2.0,2140,6360,2.0,3,1840,300,98115
551000.0,3,2.5,2010,17362,2.0,3,2010,0,98033
230000.0,3,2.25,1500,7210,1.0,3,1150,350,98023
325000.0,3,2.25,1440,6443,2.0,3,1440,0,98019
259000.0,4,1.75,1580,8856,2.0,3,1580,0,98045
306000.0,3,1.5,1250,8700,1.0,4,1250,0,98168
705000.0,3,2.75,2260,4000,2.0,4,1540,720,98109
359000.0,4,2.5,1820,11325,1.0,3,1390,430,98166
850000.0,3,2.0,2470,8800,2.0,3,2470,0,98040
618500.0,3,2.0,1800,5000,1.0,4,1080,720,98115
295000.0,3,1.5,1670,10800,1.0,4,1670,0,98022
595000.0,3,2.5,2550,6677,2.0,3,2550,0,98028
261000.0,3,1.75,1350,7686,1.0,3,1350,0,98038
589000.0,3,1.5,1390,5040,1.0,3,1090,300,98105
230000.0,3,1.75,1720,9125,1.0,4,1140,580,98092
524000.0,4,2.25,2190,15491,2.0,3,2190,0,98074
330000.0,3,2.0,2500,10697,1.0,3,2500,0,98022
401000.0,3,1.5,1470,6867,1.0,3,1470,0,98155
270000.0,3,2.0,1820,7750,1.0,3,1820,0,98023
705000.0,4,2.0,2060,6000,1.0,4,1370,690,98136
325000.0,3,2.0,1670,17071,1.0,3,1100,570,98014
353000.0,3,2.5,2550,6021,2.0,3,2550,0,98030
305000.0,4,2.5,2430,5959,2.0,3,2430,0,98092
219200.0,3,2.0,1680,7000,1.5,4,1680,0,98002
455000.0,3,1.5,1250,8004,1.0,3,1250,0,98008
300000.0,3,1.5,1320,15053,1.0,3,1320,0,98072
520000.0,3,1.75,1430,53628,2.0,3,1430,0,98024
358000.0,3,1.5,1250,7194,1.0,4,1250,0,98034
543000.0,4,2.25,2060,8767,2.0,3,2060,0,98052
330000.0,4,2.25,2000,10679,1.0,3,1350,650,98148
529000.0,3,2.0,1530,3400,1.0,3,990,540,98112
544000.0,3,1.5,1790,8203,1.5,3,1790,0,98116
672600.0,3,2.25,1520,5750,2.0,3,1400,120,98116
613000.0,3,1.5,1470,4480,1.0,4,1130,340,98105
808000.0,4,2.25,2500,8866,2.0,4,2500,0,98007
340000.0,3,1.75,1210,9635,1.0,4,1210,0,98019
550000.0,3,1.5,1340,6000,1.0,4,1340,0,98040
475000.0,3,2.5,1630,7586,2.0,3,1630,0,98029
432100.0,3,1.75,1840,7350,1.0,3,1310,530,98034
300000.0,3,2.25,1960,1585,2.0,3,1750,210,98118
245000.0,4,1.75,1930,7650,1.0,4,1280,650,98023
698000.0,3,1.75,1220,7447,1.0,4,1220,0,98033
287500.0,4,2.25,2250,12000,2.0,3,2250,0,98032
602000.0,4,1.75,2420,37800,1.0,4,1880,540,98053
206000.0,4,2.0,1700,6025,1.0,3,1700,0,98002
491150.0,3,2.5,1470,3971,2.0,3,1470,0,98053
390000.0,4,2.75,2500,12848,1.0,3,2120,380,98003
635000.0,4,2.0,2260,8457,2.0,3,2260,0,98074
625000.0,3,1.75,2700,18893,1.0,4,2110,590,98010
325000.0,3,2.0,1570,5600,1.0,3,1570,0,98058
235000.0,3,1.75,1950,8712,1.0,3,1950,0,98055
223000.0,4,2.0,1200,8470,1.0,4,1200,0,98023
630000.0,4,1.75,1770,12278,1.0,3,1350,420,98115
339000.0,3,1.5,1740,21980,1.0,4,1740,0,98042
269000.0,3,2.0,1410,10577,1.0,3,1410,0,98030
405000.0,3,2.5,2070,4697,2.0,3,2070,0,98065
572000.0,3,2.5,2360,9938,1.0,3,1690,670,98027
365650.0,4,2.25,2380,7700,2.0,4,2380,0,98055
299000.0,3,2.0,1730,6007,1.0,3,1730,0,98030
435000.0,3,2.5,2260,5100,2.0,3,2260,0,98019
427500.0,3,1.75,1430,16200,1.0,4,1430,0,98027
688000.0,3,1.5,1760,4880,1.5,3,1290,470,98136
195000.0,4,1.75,1320,7694,1.0,3,1320,0,98148
732500.0,3,2.5,2470,10321,2.0,3,2470,0,98052
526000.0,4,2.0,1610,8000,1.0,3,1190,420,98008
526000.0,3,1.75,1530,6125,1.0,3,1120,410,98116
325000.0,3,2.0,1750,9000,1.5,4,1750,0,98133
192000.0,3,1.75,1240,10361,1.0,3,1240,0,98042
815000.0,4,2.0,1400,4800,2.0,3,1400,0,98122
480000.0,3,2.5,2270,4488,2.0,3,2270,0,98065
600000.0,4,2.5,2560,5593,2.0,3,2560,0,98053
299500.0,4,2.5,2010,12085,2.0,3,2010,0,98042
460000.0,3,2.5,1690,5131,1.0,3,1690,0,98126
483000.0,4,1.5,1220,3780,1.5,3,1220,0,98107
377000.0,4,2.5,2170,11511,2.0,3,2170,0,98031
640000.0,4,1.75,2100,3000,1.5,4,1500,600,98103
352000.0,4,1.75,1850,5712,1.0,3,1850,0,98115
588000.0,4,2.25,2580,7344,2.0,3,2580,0,98027
260000.0,3,1.5,1750,7000,2.0,3,1750,0,98023
222400.0,3,2.0,1200,9566,1.0,3,1200,0,98001
550000.0,3,1.75,1520,5618,1.0,3,1170,350,98115
249000.0,3,2.5,1850,7200,1.0,3,1500,350,98023
395000.0,4,2.75,1970,37026,1.0,4,1970,0,98070
690000.0,3,2.0,1890,6620,1.0,4,1890,0,98125
526500.0,3,1.5,1310,7236,1.0,4,1170,140,98103
325000.0,4,1.5,1870,7220,2.0,3,1870,0,98155
383000.0,3,1.5,1400,14850,1.5,4,1400,0,98070
275000.0,3,2.5,2030,6326,2.0,3,2030,0,98038
300000.0,3,2.25,1730,10030,1.0,4,1730,0,98023
525000.0,3,2.5,1720,7950,1.5,4,1720,0,98034
570000.0,3,1.75,1210,7350,1.0,3,1210,0,98033
699950.0,3,2.5,2510,4106,2.0,3,2510,0,98029
330000.0,4,2.0,1590,9100,1.0,3,1040,550,98058
537000.0,4,1.75,2230,7957,1.0,4,2230,0,98008
350000.0,3,1.75,1740,29597,1.0,4,1740,0,98059
388000.0,4,2.5,2440,7155,2.0,3,2440,0,98058
425000.0,4,1.5,1600,6180,1.5,3,1600,0,98118
645000.0,4,1.5,1600,6180,1.5,3,1600,0,98118
430000.0,3,2.75,2550,11160,2.0,3,2550,0,98155
280000.0,3,2.25,1700,7210,1.0,4,1250,450,98003
215000.0,3,2.0,1470,2052,1.5,3,1470,0,98003
306000.0,3,2.5,1680,11193,2.0,3,1680,0,98058
309000.0,3,2.5,1990,3614,2.0,3,1990,0,98038
759000.0,3,1.5,1980,5800,1.0,4,1520,460,98199
229000.0,4,1.5,1820,22814,1.5,3,1820,0,98125
325000.0,4,2.25,2130,8499,1.0,4,1600,530,98030
247500.0,3,2.25,1620,6000,1.0,3,1280,340,98002
199950.0,3,1.5,1370,10317,1.5,3,1370,0,98168
275000.0,3,2.0,1540,10410,1.0,4,1540,0,98198
255000.0,3,2.0,1490,8371,1.5,3,1490,0,98031
259000.0,3,1.75,1260,3604,1.0,3,1260,0,98042
505000.0,3,1.75,1800,7210,1.0,3,1370,430,98072
740000.0,3,1.5,1830,4000,1.0,4,1350,480,98119
650000.0,3,2.5,2220,6380,1.5,4,1660,560,98115
529941.0,3,2.0,1660,10000,1.0,4,1010,650,98005
443000.0,3,1.75,1810,7950,1.0,4,1810,0,98008
585000.0,4,2.5,2370,15200,1.0,3,1660,710,98052
315000.0,3,2.5,1880,7000,2.0,3,1880,0,98031
322500.0,3,2.0,1350,14200,1.0,3,1350,0,98019
424000.0,4,2.0,2100,4857,2.0,3,2100,0,98155
650000.0,3,2.5,2180,37042,2.0,3,2180,0,98077
490000.0,3,2.25,2550,8588,1.0,3,2550,0,98011
469950.0,4,2.75,2530,14178,2.0,3,2530,0,98019
536000.0,3,1.75,1300,5413,1.5,3,1300,0,98115
244950.0,4,2.5,1790,19177,1.0,4,1790,0,98030
520000.0,3,2.25,1850,10855,1.0,3,1370,480,98029
239950.0,3,1.75,1440,7200,1.0,3,1440,0,98188
335000.0,3,1.5,2040,6000,1.0,3,1340,700,98118
612000.0,3,2.5,2120,7401,2.0,3,2120,0,98029
855000.0,4,2.25,2190,4080,2.0,3,1800,390,98119
208000.0,3,1.5,1210,7247,1.0,4,1210,0,98003
474950.0,3,2.25,1850,2575,2.0,3,1850,0,98118
419000.0,3,2.25,1760,16418,1.0,3,1190,570,98053
835000.0,3,2.25,2120,54014,2.0,4,2120,0,98005
310000.0,4,2.5,2130,9013,2.0,3,2130,0,98001
685000.0,3,1.75,1940,7313,1.0,4,1440,500,98136
540000.0,3,2.5,2400,5817,2.0,3,2400,0,98065
295000.0,4,2.5,1810,4871,2.0,3,1810,0,98031
475000.0,4,2.5,2040,16200,2.0,3,2040,0,98019
265000.0,3,2.5,1660,5250,2.0,4,1660,0,98003
380000.0,3,2.5,1980,17342,2.0,3,1580,400,98166
475000.0,3,2.5,2160,35912,2.0,3,2160,0,98077
440000.0,3,2.25,1760,10835,1.0,4,1290,470,98027
335000.0,4,1.75,2000,10890,1.0,4,1390,610,98003
740000.0,4,2.5,2300,9900,1.0,3,1600,700,98136
270000.0,3,2.25,2140,9990,1.0,4,2140,0,98003
510000.0,4,2.0,2210,5572,1.5,3,1760,450,98126
675000.0,4,2.0,1890,5188,1.5,4,1670,220,98105
245000.0,4,2.25,2140,8800,2.0,4,2140,0,98032
381000.0,3,1.75,1330,7216,1.0,3,1330,0,98034
232603.0,3,1.75,1750,11461,2.0,4,1750,0,98002
239000.0,3,2.5,1360,5754,2.0,3,1360,0,98030
400000.0,3,1.75,1730,9211,1.0,3,1730,0,98125
680000.0,4,2.5,2520,5000,2.0,3,2520,0,98029
391265.0,3,2.0,1440,3900,1.0,3,1440,0,98053
316000.0,4,1.5,2120,46173,2.0,3,2120,0,98053
325000.0,4,2.5,1820,9161,1.0,4,1220,600,98058
682000.0,4,2.5,2390,53941,2.0,3,2390,0,98053
430000.0,3,2.5,1400,7508,2.0,4,1400,0,98034
325500.0,3,1.5,1540,8110,1.0,4,1190,350,98125
268000.0,3,1.75,1480,8009,1.0,3,980,500,98032
675000.0,4,2.25,2260,8715,1.0,4,1530,730,98008
620000.0,4,2.25,2210,10039,1.0,4,1710,500,98052
410000.0,3,1.75,1760,3520,1.0,3,1160,600,98144
716125.0,3,2.25,2110,7279,1.0,4,2110,0,98033
279000.0,4,2.5,2040,8076,2.0,3,2040,0,98042
507000.0,4,2.25,1490,956,2.0,3,1020,470,98122
291000.0,3,1.75,1560,9788,1.0,3,1560,0,98178
329000.0,3,1.75,1980,7000,1.0,4,1360,620,98058
345000.0,3,2.5,1620,5992,2.0,3,1620,0,98019
497000.0,4,2.5,2240,7200,2.0,3,2240,0,98118
313500.0,3,1.75,1610,7350,1.0,3,1610,0,98058
309000.0,3,2.25,1980,8755,1.0,4,1300,680,98198
410000.0,3,2.5,1960,4400,2.0,3,1960,0,98065
450000.0,3,2.5,2480,5647,2.0,3,2480,0,98065
308900.0,3,2.5,2250,7294,2.0,3,2250,0,98092
560000.0,3,2.5,2180,7169,2.0,3,2180,0,98029
579000.0,3,2.5,2300,18540,1.0,3,1800,500,98177
485000.0,3,2.5,2270,7887,2.0,3,2270,0,98065
552000.0,3,2.5,1840,9900,1.0,3,1840,0,98007
203700.0,3,2.0,1660,7958,1.0,3,1130,530,98092
237500.0,3,2.0,1350,8960,1.0,4,1350,0,98038
200000.0,3,2.0,1190,6833,1.0,3,1190,0,98092
280000.0,3,1.75,1670,6034,1.0,3,990,680,98118
365000.0,3,2.0,2030,8649,1.0,3,2030,0,98056
550000.0,3,2.25,1880,11556,2.0,3,1880,0,98074
375000.0,3,1.75,2190,17550,1.0,3,2190,0,98014
717500.0,3,2.5,2530,9932,2.0,3,2530,0,98052
629000.0,3,2.0,1510,4560,2.0,4,1510,0,98116
315000.0,3,2.5,1730,6368,2.0,3,1730,0,98038
550000.0,3,2.25,1950,26500,1.0,4,1570,380,98006
724950.0,4,2.0,2270,5760,2.0,4,2270,0,98116
512000.0,4,2.5,2600,4506,2.0,3,2600,0,98056
285000.0,3,2.5,1660,6263,2.0,3,1660,0,98042
290000.0,4,1.75,2090,12750,1.0,3,1360,730,98166
725000.0,3,1.75,1690,8489,1.0,4,1690,0,98004
289999.0,3,2.0,1490,9285,1.0,3,1490,0,98092
275000.0,3,2.25,1820,9766,1.0,4,1450,370,98031
250000.0,3,2.25,1765,7652,2.0,3,1765,0,98003
665000.0,3,2.75,1800,9550,1.0,4,1320,480,98006
447000.0,3,2.5,1650,3076,2.0,3,1650,0,98053
560000.0,4,2.0,1380,4048,1.5,4,1380,0,98103
299500.0,3,1.75,1880,11700,1.0,4,1880,0,98092
450000.0,3,2.25,2530,27227,2.0,3,2530,0,98056
375000.0,3,2.75,1890,3930,2.0,3,1890,0,98065
707000.0,3,1.5,1980,4000,2.0,3,1980,0,98109
600000.0,4,2.5,1960,14242,1.0,4,1290,670,98146
715000.0,4,2.5,2570,7980,2.0,3,2570,0,98074
240000.0,3,1.75,1420,6984,1.0,4,980,440,98030
283500.0,3,1.75,1250,5375,1.0,3,1250,0,98198
250000.0,3,2.0,1470,2781,2.0,3,1470,0,98038
405000.0,3,2.25,1660,8307,1.0,4,1660,0,98133
791000.0,3,2.25,2430,5500,2.0,3,1810,620,98033
424500.0,3,1.75,1460,7700,1.0,3,1460,0,98052
865000.0,4,2.5,2580,10631,2.0,4,2580,0,98033
325000.0,3,1.75,1810,8048,1.0,4,1290,520,98055
179000.0,4,1.75,1790,7175,1.5,3,1410,380,98168
266490.0,3,2.5,1810,4113,2.0,3,1810,0,98042
635500.0,3,2.0,1660,3600,1.0,3,1000,660,98103
450000.0,3,2.5,1460,7573,2.0,3,1460,0,98007
375000.0,3,2.5,1830,13042,2.0,3,1830,0,98038
685000.0,3,2.0,2500,6733,1.0,3,1770,730,98107
252000.0,3,2.0,1540,7210,2.0,4,1540,0,98023
512500.0,4,2.25,2200,6900,2.0,4,2200,0,98028
423800.0,3,2.5,1940,7415,2.0,3,1940,0,98006
460000.0,3,2.25,1453,2225,2.0,4,1453,0,98006
434000.0,3,2.75,1830,3200,2.0,3,1830,0,98034
450000.0,3,2.0,1680,11250,1.0,4,1680,0,98045
475000.0,4,2.25,1970,7532,1.0,3,1390,580,98052
350000.0,3,2.0,1440,5469,1.0,3,1440,0,98029
500000.0,4,2.0,1530,7816,1.0,3,1530,0,98133
400000.0,3,1.5,1510,7642,1.0,3,1510,0,98008
328000.0,3,1.75,1440,45302,2.0,3,1440,0,98019
535000.0,3,2.5,1960,47044,2.0,4,1960,0,98077
464950.0,3,2.0,2190,19800,1.0,3,2190,0,98146
727500.0,3,2.0,2660,5000,1.5,3,1940,720,98116
325000.0,4,1.75,1670,9500,1.0,3,1670,0,98125
319000.0,3,2.25,1800,9597,1.0,3,1200,600,98188
900000.0,3,2.5,2320,5000,2.0,3,1620,700,98112
229500.0,3,1.75,1770,33224,1.0,4,1770,0,98092
589000.0,3,2.5,2320,5663,2.0,3,2320,0,98027
279950.0,3,1.5,1520,7200,1.0,4,1160,360,98198
252500.0,3,2.0,1900,8002,1.0,3,1900,0,98023
700000.0,3,2.5,2190,7982,2.0,3,2190,0,98033
270000.0,3,2.5,1780,5015,2.0,3,1780,0,98042
450000.0,4,2.5,2300,19250,1.0,4,2300,0,98045
720000.0,4,2.5,2650,11520,2.0,3,2110,540,98033
403000.0,3,2.25,1840,13020,1.0,3,1390,450,98052
270000.0,4,2.5,1900,8282,1.0,3,1900,0,98022
260000.0,3,1.75,1360,15210,1.0,3,1360,0,98038
391500.0,3,2.5,1920,9625,2.0,3,1920,0,98045
555000.0,4,1.75,2320,4800,1.5,3,2170,150,98117
550000.0,3,1.5,1730,5750,1.0,3,1250,480,98116
295000.0,3,1.75,2000,7560,1.0,4,1300,700,98058
300000.0,3,1.75,1420,7200,1.0,3,1000,420,98146
249900.0,3,2.0,1310,6738,1.0,4,1310,0,98042
675000.0,3,2.25,1780,4252,2.0,4,1540,240,98144
447000.0,3,2.25,1440,4667,2.0,3,1440,0,98029
675000.0,3,2.0,1510,3817,1.5,3,1510,0,98122
650000.0,3,1.5,1320,8114,1.0,3,1320,0,98004
585000.0,3,2.5,1740,2350,2.0,3,1130,610,98112
565000.0,4,2.5,2500,12090,1.0,3,2500,0,98074
315000.0,3,2.5,2200,5954,2.0,3,2200,0,98042
370000.0,3,1.5,2380,14500,1.0,4,1850,530,98028
272500.0,3,2.0,1410,7622,1.0,4,1410,0,98058
355000.0,3,1.75,1730,7416,1.5,3,1730,0,98133
342000.0,4,2.5,2380,7792,2.0,3,2380,0,98092
330000.0,3,2.5,1870,4657,2.0,3,1870,0,98055
279000.0,4,2.5,1810,13000,1.0,4,1470,340,98022
812000.0,4,2.5,2270,5000,2.0,3,2270,0,98117
242000.0,4,2.5,1750,11400,2.0,4,1750,0,98023
289000.0,3,2.25,1670,6600,2.0,4,1670,0,98042
400000.0,3,2.0,1860,12944,1.0,3,1860,0,98058
628990.0,4,2.5,2540,32647,2.0,3,2540,0,98053
359000.0,3,1.75,2200,11520,1.0,4,2200,0,98133
535000.0,4,1.75,1420,5000,1.5,4,1420,0,98117
365000.0,3,2.25,1800,9010,1.0,3,1300,500,98155
570000.0,3,2.0,1530,5401,1.0,4,1530,0,98115
383000.0,3,1.75,1500,13430,1.0,3,1500,0,98072
371000.0,4,1.75,1690,10854,1.0,3,1690,0,98056
530000.0,3,1.75,1430,10350,1.0,3,1430,0,98008
225000.0,3,1.75,1610,14182,1.0,4,1100,510,98092
660000.0,3,2.5,2390,15669,2.0,3,2390,0,98011
224000.0,3,1.75,1760,6300,1.0,3,1060,700,98178
244000.0,3,1.75,1540,8885,1.0,4,1440,100,98031
330000.0,4,2.5,2240,7589,2.0,3,2240,0,98030
509000.0,4,2.0,1630,1724,1.5,3,1030,600,98119
440000.0,4,2.5,2350,7203,2.0,3,2350,0,98059
244000.0,3,2.0,1350,8587,1.0,3,1350,0,98022
519000.0,4,2.5,1950,2617,1.5,4,1250,700,98107
410000.0,3,2.5,1830,2839,2.0,3,1830,0,98074
750000.0,4,2.0,2640,5000,2.0,3,2040,600,98117
240000.0,3,2.0,1553,6550,1.0,3,1553,0,98022
539000.0,3,2.5,1710,2300,2.0,3,1570,140,98052
465000.0,3,1.5,1270,5112,1.0,3,1270,0,98115
296475.0,3,2.5,1520,4170,2.0,3,1520,0,98038
330000.0,4,2.0,1820,9450,1.0,3,1100,720,98155
445000.0,3,2.25,1800,11200,1.0,3,1270,530,98052
725000.0,4,1.75,1980,5850,1.0,4,1380,600,98116
369000.0,4,2.5,2550,7349,2.0,3,2550,0,98023
535000.0,3,2.0,2120,4080,2.0,3,2120,0,98053
229999.0,3,1.75,1310,6960,1.0,4,1310,0,98092
260000.0,3,2.5,1440,2500,2.0,3,1440,0,98146
525000.0,4,2.75,2300,26650,1.0,4,2300,0,98177
620000.0,3,2.25,2010,7495,1.0,4,1570,440,98027
229000.0,3,1.5,1200,5000,1.0,3,1200,0,98146
495000.0,4,2.25,2350,10072,2.0,3,2350,0,98011
586000.0,4,2.25,1930,8338,1.0,3,1930,0,98125
320000.0,4,2.25,2310,7490,2.0,3,2310,0,98055
349000.0,3,1.75,1590,9620,1.0,3,1590,0,98059
523000.0,3,2.5,2400,6182,2.0,3,2400,0,98065
289950.0,4,1.75,1500,8400,1.0,3,1200,300,98188
490000.0,4,2.25,1960,10275,2.0,3,1960,0,98052
872500.0,4,2.0,1990,6000,1.0,3,1260,730,98199
539000.0,3,1.5,1740,12000,2.0,3,1740,0,98074
269950.0,3,2.5,1520,8720,1.0,3,1080,440,98058
300000.0,3,1.75,1310,9761,1.0,3,1310,0,98034
278000.0,3,2.25,2120,9804,2.0,3,2120,0,98042
342000.0,3,2.25,1200,2845,2.0,3,1200,0,98034
190000.0,4,1.75,1900,9861,1.0,4,1900,0,98038
279950.0,3,2.25,1850,7480,2.0,3,1850,0,98058
774888.0,3,2.25,2420,23507,1.0,4,2420,0,98027
492650.0,4,1.75,2120,9786,1.0,3,1640,480,98177
277500.0,4,2.0,1700,12048,2.0,3,1700,0,98030
299500.0,3,1.75,1810,34500,1.0,3,1230,580,98032
246000.0,4,1.5,2120,7110,1.5,3,2120,0,98030
518000.0,4,2.5,2560,5672,2.0,3,2560,0,98056
487585.0,4,1.75,2010,9211,1.0,3,1470,540,98034
819000.0,3,1.75,1850,6000,1.5,3,1650,200,98199
480000.0,3,2.25,1820,15000,1.0,3,1480,340,98028
578000.0,4,2.5,2070,5415,2.0,3,2070,0,98029
425000.0,3,1.5,1390,9680,1.0,4,1390,0,98008
500000.0,4,2.0,2120,7806,1.0,4,1770,350,98033
484998.0,4,2.5,1540,1870,2.0,3,1540,0,98029
210000.0,3,1.75,1590,7617,2.0,3,1590,0,98198
415000.0,3,1.75,1470,4000,1.0,3,1070,400,98122
379950.0,3,1.5,1690,9144,1.0,4,1140,550,98028
588000.0,3,1.75,2310,7620,2.0,3,2310,0,98177
419000.0,3,2.25,1700,7650,1.0,4,1340,360,98034
419950.0,4,2.5,2260,5164,2.0,3,2260,0,98056
255000.0,3,2.25,1850,7151,2.0,3,1850,0,98023
481000.0,4,1.75,1920,9500,1.0,4,1470,450,98006
719521.0,4,1.75,1920,9500,1.0,4,1470,450,98006
556000.0,3,1.75,1640,7437,1.0,3,1090,550,98126
900000.0,4,2.0,1980,7200,2.0,3,1700,280,98119
321000.0,4,2.25,1800,4500,2.0,4,1800,0,98031
323000.0,3,1.75,1950,15037,1.0,3,1950,0,98014
640000.0,4,2.5,2320,11259,2.0,3,2320,0,98004
269950.0,3,1.5,1740,9547,1.0,4,1740,0,98055
340768.0,3,1.5,1510,11200,1.0,4,1510,0,98003
320000.0,3,2.0,1420,1716,2.0,3,1050,370,98155
263000.0,4,1.75,1340,8700,1.5,3,1340,0,98188
257000.0,3,1.75,1397,18000,1.0,3,1397,0,98092
300000.0,3,2.25,2000,7560,1.0,3,1400,600,98055
328000.0,3,2.0,2250,7904,1.5,3,2250,0,98001
515000.0,3,1.5,1660,5100,1.0,4,1210,450,98136
669000.0,4,2.5,2470,4945,2.0,3,2470,0,98053
335000.0,3,2.0,1570,7200,1.0,4,1570,0,98155
506950.0,3,2.5,2080,4931,2.0,3,2080,0,98065
812000.0,3,2.5,2040,4559,2.0,3,2040,0,98122
377500.0,3,2.25,1410,1377,2.0,3,1290,120,98027
413800.0,3,2.0,1440,4421,1.0,3,1440,0,98053
377000.0,3,2.5,1870,5333,2.0,3,1870,0,98019
329900.0,4,2.75,2475,4000,2.0,3,2475,0,98002
363990.0,4,2.5,2240,3712,2.0,3,2240,0,98038
399000.0,3,2.0,2100,31550,1.0,3,2100,0,98014
338900.0,3,2.25,1936,9495,1.0,3,1936,0,98030
493000.0,4,2.5,2070,4270,2.0,3,2070,0,98028
456000.0,3,2.5,2130,5205,2.0,3,2130,0,98045
274000.0,3,2.5,1830,2517,2.0,3,1830,0,98055
267800.0,3,1.75,1410,1899,2.0,3,1410,0,98106
369950.0,3,2.5,1930,8254,2.0,3,1930,0,98146
275000.0,4,2.5,1830,3868,2.0,3,1830,0,98118
425000.0,4,2.5,2070,4427,2.0,3,2070,0,98065
340000.0,3,2.0,1920,5688,1.0,3,1920,0,98022
375000.0,3,2.5,1600,2042,2.0,3,1600,0,98027
280000.0,3,2.75,1740,5639,1.0,3,1740,0,98022
359000.0,4,2.5,2575,4725,2.0,3,2575,0,98001
375000.0,4,2.5,2310,7800,2.0,3,2310,0,98042
319000.0,4,2.5,2020,5100,2.0,3,2020,0,98023
340000.0,4,2.5,2320,4142,2.0,3,2320,0,98038
250000.0,3,2.5,1750,6351,2.0,3,1750,0,98001
349500.0,4,2.5,2030,4596,2.0,3,2030,0,98001
290750.0,3,2.5,1270,865,2.0,3,1080,190,98118
689950.0,4,2.75,2520,8433,2.0,3,2520,0,98125
319900.0,4,2.75,2475,4276,2.0,3,2475,0,98002
263000.0,3,2.5,1584,3200,2.0,3,1584,0,98002
505000.0,4,2.5,2420,5006,2.0,3,2420,0,98059
400000.0,3,2.5,2393,4788,2.0,3,2393,0,98055
327555.0,3,2.5,2329,5720,2.0,3,2329,0,98030
673000.0,4,2.25,2580,2875,2.0,3,2580,0,98116
384435.0,3,2.5,2029,3906,2.0,3,2029,0,98003
282000.0,3,2.25,1260,915,2.0,3,1020,240,98106
450000.0,3,2.5,1800,4357,2.0,3,1800,0,98065
450000.0,3,2.5,2280,4557,2.0,3,2280,0,98028
759990.0,4,2.5,2540,5760,2.0,3,2540,0,98029
355000.0,4,2.75,2050,4000,2.0,3,2050,0,98001
629800.0,3,2.5,2390,1984,2.0,3,2220,170,98027
282000.0,4,2.5,1785,2552,2.0,3,1785,0,98030
385000.0,4,2.0,2340,9716,1.0,3,2340,0,98146
331210.0,4,2.5,2240,4800,2.0,3,2240,0,98001
245000.0,3,1.5,1260,1270,2.0,3,1040,220,98133
328000.0,4,2.5,1850,5388,2.0,3,1850,0,98038
445000.0,3,2.5,1550,930,2.0,3,1060,490,98144
362500.0,3,2.5,1800,2700,2.0,3,1800,0,98126
679950.0,3,2.5,2230,3939,2.0,3,2230,0,98133
290000.0,4,2.5,2423,7292,2.0,3,2423,0,98023
349900.0,4,2.5,2052,3723,2.0,3,2052,0,98003
509900.0,3,2.5,1790,2700,2.0,3,1790,0,98027
282000.0,3,2.5,2010,5399,2.0,3,2010,0,98042
387865.0,3,2.5,2370,4200,2.0,3,2370,0,98038
385000.0,4,2.5,2560,6238,2.0,3,2560,0,98178
536000.0,3,2.5,1900,6224,2.0,3,1900,0,98075
348000.0,3,2.5,1500,2255,2.0,3,1500,0,98029
364000.0,3,2.5,1800,2790,2.0,3,1800,0,98126
710000.0,3,2.5,2440,4153,2.0,3,2440,0,98052
326989.0,3,2.5,2060,4200,2.0,3,2060,0,98038
335606.0,3,2.5,2538,4600,2.0,3,2538,0,98092
299950.0,3,2.5,1320,3150,2.0,3,1320,0,98118
366000.0,3,2.25,1445,1028,2.0,3,1300,145,98027
480000.0,4,2.5,2430,5000,2.0,3,2430,0,98065
730000.0,3,2.5,1860,1290,2.0,3,1240,620,98122
530000.0,4,2.5,2590,7891,2.0,3,2590,0,98056
610360.0,4,2.5,2610,5562,2.0,3,2610,0,98056
449950.0,4,2.5,2420,5244,2.0,3,2420,0,98166
293000.0,3,2.25,1910,3481,2.0,3,1910,0,98055
285000.0,3,2.5,2437,5136,2.0,3,2437,0,98002
379900.0,3,2.5,1800,2791,2.0,3,1800,0,98126
300000.0,4,2.5,2090,5195,2.0,3,2090,0,98031
515000.0,3,2.5,2610,5845,2.0,3,2610,0,98059
439000.0,3,2.5,1680,2801,2.0,3,1680,0,98011
540000.0,3,2.5,2220,5279,2.0,3,2220,0,98146
328000.0,3,2.5,2242,4800,2.0,3,2242,0,98092
435000.0,4,2.5,2150,3143,2.0,3,2150,0,98059
625000.0,3,2.5,2440,4800,2.0,3,2440,0,98106
400000.0,3,2.25,1450,4706,2.0,3,1450,0,98028
333500.0,3,2.5,2196,7475,2.0,3,2196,0,98030
430000.0,3,2.25,2020,2750,2.0,3,1680,340,98108
334990.0,4,2.5,2220,4228,2.0,3,2220,0,98146
210000.0,3,2.0,1580,4961,2.0,3,1580,0,98042
350000.0,3,2.5,2040,13590,2.0,3,2040,0,98042
395000.0,3,2.5,2130,5088,2.0,3,1840,290,98019
215000.0,4,2.5,1847,8000,2.0,3,1847,0,98001
390000.0,4,2.5,2610,7227,2.0,3,2610,0,98010
389950.0,4,2.5,2240,5500,2.0,3,2240,0,98056
500000.0,3,2.5,1720,3012,2.0,3,1720,0,98133
430000.0,3,2.5,1950,4949,2.0,3,1950,0,98065
450000.0,3,2.5,2410,4293,2.0,3,2410,0,98065
435000.0,4,2.25,2140,6355,2.0,3,2140,0,98065
398000.0,3,2.5,1720,1715,2.0,3,1240,480,98136
380000.0,3,1.75,1690,1468,2.0,3,1380,310,98108
408000.0,3,2.25,1950,7221,1.0,4,1950,0,98188
339990.0,3,2.5,2570,4600,2.0,3,2570,0,98092
541000.0,3,1.75,1630,1166,2.0,3,1020,610,98107
375000.0,4,2.5,2510,7245,2.0,3,2510,0,98146
320000.0,4,2.5,2223,5780,2.0,3,2223,0,98042
455000.0,4,2.5,2090,4400,2.0,3,2090,0,98118
292500.0,3,2.5,1440,1068,2.0,3,1160,280,98106
395000.0,4,2.75,2280,5013,2.0,3,2280,0,98019
443000.0,3,2.5,1780,2778,2.0,3,1530,250,98126
260000.0,3,2.5,1427,4337,2.0,3,1427,0,98042
445000.0,4,2.5,2170,6000,2.0,3,1630,540,98106
711000.0,3,2.5,2550,5376,2.0,3,2550,0,98052
320000.0,4,2.5,2300,3825,2.0,3,2300,0,98042
631625.0,4,2.5,2440,6651,2.0,3,2440,0,98117
689500.0,4,2.5,2050,2772,2.0,3,2050,0,98029
175003.0,3,1.5,1390,1882,2.0,3,1390,0,98108
447055.0,4,2.5,2448,4949,2.0,3,2448,0,98030
249900.0,3,2.5,1610,3517,2.0,3,1610,0,98055
685000.0,3,2.25,1710,1193,2.0,3,1140,570,98122
295000.0,3,1.5,1220,3286,2.0,3,1220,0,98033
260000.0,3,2.25,1489,2800,2.0,3,1489,0,98002
380000.0,3,2.25,1530,1305,2.0,3,1116,414,98177
287000.0,3,2.5,1600,6315,2.0,3,1600,0,98092
341000.0,3,2.5,1480,1663,2.0,3,1180,300,98126
739000.0,3,2.5,2310,7348,1.0,3,2310,0,98053
459000.0,3,2.0,1480,800,2.0,3,1000,480,98136
240000.0,3,2.25,1481,2820,2.0,3,1481,0,98002
399440.0,4,2.5,2311,4396,2.0,3,2311,0,98092
415000.0,4,2.5,2544,4071,2.0,3,2544,0,98030
384000.0,3,2.25,1430,800,2.0,3,1140,290,98136
415000.0,3,2.5,2280,6031,2.0,3,2280,0,98019
275000.0,3,2.5,2217,8019,2.0,3,2217,0,98001
498000.0,3,2.5,2480,4136,2.0,3,2480,0,98059
754950.0,3,2.5,2610,7256,2.0,3,2610,0,98033
245000.0,4,2.5,1921,4888,2.0,3,1921,0,98001
417000.0,3,2.5,1570,4926,2.0,3,1570,0,98065
555000.0,3,2.5,1940,3211,2.0,3,1940,0,98027
555000.0,3,2.5,1940,3211,2.0,3,1940,0,98027
353000.0,4,2.5,2210,13721,2.0,3,2210,0,98042
539000.0,3,2.25,1280,1187,2.0,3,1080,200,98107
434900.0,3,2.0,1520,5040,2.0,3,1520,0,98177
379950.0,4,2.5,2612,5850,2.0,3,2612,0,98030
700000.0,3,2.5,2350,4975,2.0,3,2350,0,98029
675000.0,3,2.5,1300,1590,2.0,3,1100,200,98109
379000.0,4,1.5,2020,7560,1.0,4,2020,0,98059
571000.0,3,2.5,2140,2867,2.0,3,1960,180,98027
475000.0,3,2.25,1380,1621,2.0,3,1140,240,98117
428900.0,4,2.5,2598,5553,2.0,3,2598,0,98092
329900.0,3,2.5,2242,4995,2.0,3,2242,0,98092
449950.0,4,2.75,2320,4344,2.0,3,2320,0,98059
388000.0,4,2.5,2090,5040,2.0,3,2090,0,98055
417838.0,4,2.5,2530,5048,2.0,3,2530,0,98038
368000.0,3,2.5,1370,1350,2.0,3,1010,360,98136
307000.0,4,2.5,1714,3080,2.0,3,1714,0,98055
310000.0,3,2.5,2540,4775,2.0,3,2540,0,98042
320000.0,3,2.5,1820,1855,2.0,3,1570,250,98166
375000.0,3,2.5,1580,3825,2.0,3,1580,0,98126
392137.0,3,2.0,1460,3696,2.0,3,1460,0,98053
439990.0,3,2.5,1930,1348,2.0,3,1300,630,98199
635000.0,4,2.25,2240,5000,2.0,3,2240,0,98074
351000.0,3,2.5,2594,4455,2.0,3,2594,0,98001
639888.0,4,2.5,2050,2772,2.0,3,2050,0,98029
899900.0,4,2.5,2580,3909,2.0,3,2580,0,98033
252000.0,3,2.5,1670,4020,2.0,3,1670,0,98118
254950.0,3,2.5,1794,4769,2.0,3,1794,0,98001
629000.0,3,2.5,2160,1912,2.0,3,1970,190,98118
734000.0,4,2.5,2180,7204,2.0,3,2180,0,98133
309000.0,3,2.25,1490,1294,2.0,3,1220,270,98106
328423.0,3,2.5,1730,3600,2.0,3,1730,0,98146
345000.0,3,1.5,1420,1192,2.0,3,1140,280,98144
248000.0,3,2.5,1870,4046,2.0,3,1870,0,98042
379000.0,4,2.5,2260,5824,2.0,3,2260,0,98038
535000.0,3,2.5,2280,2289,2.0,3,1880,400,98027
310000.0,4,2.5,2310,7384,2.0,3,2310,0,98042
383000.0,4,2.5,2050,4953,2.0,3,2050,0,98038
384500.0,3,2.5,1600,2610,2.0,3,1600,0,98027
502000.0,4,2.5,2040,5616,2.0,3,2040,0,98028
550000.0,3,2.5,2430,5400,2.0,3,2430,0,98074
660000.0,3,2.5,1780,1729,2.0,3,1080,700,98103
261950.0,3,2.5,1880,5000,2.0,3,1880,0,98042
536751.0,3,1.75,1930,6360,1.0,3,1930,0,98065
260000.0,3,2.25,1413,3403,2.0,3,1413,0,98031
535000.0,4,2.75,2360,15100,1.0,3,2360,0,98146
415000.0,3,2.25,1970,2377,2.0,3,1680,290,98108
454950.0,4,2.5,2413,5701,2.0,3,2413,0,98042
475000.0,4,2.5,2500,4500,2.0,3,2500,0,98059
205000.0,4,2.5,1767,4500,2.0,3,1767,0,98001
437718.0,3,2.5,1800,3265,2.0,3,1800,0,98065
450000.0,4,2.5,2290,5515,2.0,3,2290,0,98106
515000.0,3,2.5,1510,1178,2.0,3,1060,450,98122
585000.0,4,2.5,2430,4747,2.0,3,2430,0,98027
380000.0,3,2.25,1520,1464,2.0,3,1240,280,98126
735000.0,3,2.25,1490,1212,2.0,3,1040,450,98112
790000.0,3,2.75,2460,3600,2.0,3,2460,0,98029
392440.0,4,2.5,2547,4800,2.0,3,2547,0,98092
280000.0,4,2.25,1834,7460,2.0,3,1834,0,98042
329780.0,3,2.5,1730,3600,2.0,3,1730,0,98146
778983.0,4,2.5,2490,5647,2.0,3,2490,0,98052
338800.0,4,2.25,1800,2752,2.0,3,1800,0,98106
300000.0,3,2.5,1741,5701,2.0,3,1741,0,98030
577000.0,3,2.5,2560,5238,2.0,3,2560,0,98053
349990.0,4,2.5,2220,3561,2.0,3,2220,0,98038
650000.0,3,2.5,1910,4363,2.0,3,1910,0,98029
313200.0,3,2.5,1950,4197,2.0,3,1950,0,98042
308000.0,3,2.5,1250,1150,2.0,3,1080,170,98106
415000.0,4,2.5,2020,5501,2.0,3,2020,0,98059
216000.0,4,2.5,1847,8000,2.0,3,1847,0,98001
380000.0,4,2.5,2420,4981,2.0,3,2420,0,98038
345000.0,4,2.5,2020,3600,2.0,3,2020,0,98038
456500.0,4,2.5,2400,6811,2.0,3,2400,0,98059
382495.0,3,2.5,1760,5390,1.0,3,1760,0,98038
324950.0,4,2.5,2110,4178,2.0,3,2110,0,98042
365250.0,3,2.25,1490,4522,2.0,3,1490,0,98028
316475.0,4,2.5,1740,4642,2.0,3,1740,0,98042
298000.0,3,2.5,1852,4000,2.0,3,1852,0,98002
333000.0,3,2.5,1520,3041,2.0,3,1520,0,98059
289950.0,3,2.5,2099,4275,2.0,3,2099,0,98002
605000.0,3,2.5,2610,6405,2.0,3,2610,0,98065
767450.0,3,2.0,1630,7599,1.0,3,1630,0,98117
665000.0,3,2.25,1590,929,2.0,3,1060,530,98122
390000.0,4,2.5,2154,4153,2.0,3,2154,0,98058
399950.0,3,2.25,1360,1041,2.0,3,1094,266,98117
305000.0,3,2.5,1320,2480,2.0,3,1320,0,98118
255000.0,4,2.5,1660,6724,2.0,3,1660,0,98001
716500.0,3,2.5,2340,2155,2.0,3,2120,220,98027
540000.0,4,2.5,2190,3855,2.0,3,2190,0,98011
324747.0,3,2.5,2060,4742,2.0,3,2060,0,98038
385000.0,3,2.5,1740,4145,2.0,3,1740,0,98053
270000.0,3,2.25,1400,3825,2.0,3,1400,0,98042
672000.0,3,2.5,1780,1647,2.0,3,1080,700,98103
310000.0,3,2.5,1760,10137,2.0,3,1760,0,98038
427000.0,3,2.5,2432,9391,2.0,3,2432,0,98001
389950.0,3,2.5,2283,3996,2.0,3,2283,0,98031
309620.0,3,2.5,1860,3730,2.0,3,1860,0,98019
309780.0,3,2.5,2242,4500,2.0,3,2242,0,98092
425000.0,3,2.5,1950,4345,2.0,3,1950,0,98065
356250.0,3,2.5,2060,5115,2.0,3,2060,0,98092
362865.0,4,2.5,2245,4301,2.0,3,2245,0,98038
349950.0,3,2.0,1640,4714,1.0,3,1640,0,98038
263900.0,3,2.5,1658,2700,2.0,3,1658,0,98198
342000.0,3,2.5,1960,3540,2.0,3,1960,0,98038
367899.0,3,2.5,2420,4725,2.0,3,2420,0,98038
550000.0,4,2.5,2470,5954,2.0,3,2470,0,98028
279000.0,4,2.5,2009,4800,2.0,3,2009,0,98092
439000.0,3,2.25,1430,2343,2.0,3,1430,0,98108
310000.0,3,2.5,2242,5744,2.0,3,2242,0,98092
635000.0,4,2.5,2500,4000,2.0,3,2500,0,98144
399950.0,3,2.5,1230,922,2.0,3,1080,150,98199
494815.0,3,2.5,1910,2091,2.0,3,1910,0,98029
500000.0,3,2.25,1530,1396,2.0,3,1240,290,98107
419700.0,3,2.25,1450,1486,2.0,3,1160,290,98116
342000.0,3,2.0,1640,4802,1.0,3,1640,0,98038
274000.0,3,1.5,1450,4694,2.0,3,1450,0,98038
838000.0,4,2.5,2560,7210,2.0,3,2560,0,98136
408474.0,3,2.5,1800,2731,2.0,3,1800,0,98065
437000.0,3,2.75,2580,5200,2.0,3,2580,0,98059
499000.0,3,2.5,1861,1587,2.0,3,1578,283,98034
359950.0,4,2.75,2260,5705,2.0,3,2260,0,98042
267000.0,3,2.25,1584,2800,2.0,3,1584,0,98002
599000.0,3,2.75,1840,2060,2.0,3,1700,140,98027
324500.0,4,2.5,2110,3825,2.0,3,2110,0,98042
471500.0,3,2.5,2430,5866,2.0,3,2430,0,98065
262000.0,4,2.5,2070,8685,2.0,3,2070,0,98188
745641.0,4,2.5,2440,4850,2.0,3,2440,0,98052
339989.0,3,2.5,2060,4200,2.0,3,2060,0,98038
525000.0,3,2.5,1580,1161,2.0,3,1010,570,98112
379000.0,3,2.5,1580,3075,2.0,3,1580,0,98126
489950.0,3,2.5,2540,5237,2.0,3,2540,0,98118
391000.0,3,2.25,1410,1290,2.0,3,1290,120,98027
349900.0,3,2.5,1580,2765,2.0,3,1580,0,98126
465000.0,3,2.25,1530,1245,2.0,3,1050,480,98122
680000.0,4,2.5,2440,6581,2.0,3,2440,0,98133
399000.0,4,2.5,2480,4334,2.0,3,2480,0,98038
499000.0,3,2.5,1460,1614,2.0,3,1180,280,98117
355000.0,3,2.25,1410,1332,2.0,3,1290,120,98027
319900.0,4,2.75,2475,4000,2.0,3,2475,0,98002
280000.0,3,2.5,1608,4818,2.0,3,1608,0,98092
324950.0,4,2.5,2229,5723,2.0,3,2229,0,98032
530000.0,3,2.5,1790,3078,2.0,3,1790,0,98027
292000.0,3,2.5,1610,3848,2.0,3,1610,0,98055
584000.0,3,2.5,1480,1485,2.0,3,1280,200,98102
550000.0,3,2.5,1930,6604,2.0,3,1930,0,98166
250000.0,3,2.0,1590,8100,1.0,3,1060,530,98038
265000.0,3,2.25,1489,2800,2.0,3,1489,0,98002
430000.0,3,2.5,2075,39553,1.0,3,2075,0,98038
286800.0,3,2.5,1413,3600,2.0,3,1413,0,98031
390500.0,3,2.25,1530,1279,2.0,3,1116,414,98177
460000.0,3,2.5,2390,47480,2.0,3,2390,0,98058
344000.0,4,2.5,2400,4848,2.0,3,2400,0,98038
379500.0,4,2.5,2560,5102,2.0,3,2560,0,98092
475000.0,3,2.25,1630,2520,2.0,3,1630,0,98029
350000.0,3,2.5,1380,1590,2.0,3,1160,220,98126
490000.0,3,2.25,1280,1520,2.0,3,1080,200,98107
552500.0,3,1.5,1300,1435,2.0,3,1120,180,98122
467000.0,4,2.75,2170,5024,2.0,3,2170,0,98059
305000.0,4,2.25,1763,3717,2.0,3,1763,0,98031
429000.0,4,2.5,1840,4593,2.0,3,1840,0,98053
250000.0,3,2.25,1400,3814,2.0,3,1400,0,98042
265000.0,3,2.5,1400,3368,2.0,3,1400,0,98146
749000.0,4,2.75,2700,6000,2.0,4,2100,600,98116
492000.0,4,2.5,2550,6382,2.0,3,2550,0,98065
333000.0,3,1.5,1260,5758,2.0,3,1260,0,98006
415000.0,4,2.5,2550,4500,2.0,3,2550,0,98059
273500.0,3,2.5,1550,3402,2.0,3,1550,0,98002
392000.0,4,2.5,2130,4000,2.0,3,2130,0,98146
457000.0,3,2.5,1220,1330,2.0,3,1010,210,98117
453000.0,4,2.5,2502,8306,2.0,3,2502,0,98001
469995.0,4,2.5,2350,3800,2.0,3,2350,0,98059
540000.0,3,2.5,1810,3930,2.0,3,1810,0,98053
297000.0,4,2.5,2230,4952,2.0,3,2230,0,98002
320000.0,4,2.5,1970,4558,2.0,3,1970,0,98038
395000.0,3,2.5,1600,1936,2.0,3,1600,0,98108
732000.0,3,2.5,1960,3060,2.0,3,1960,0,98117
375000.0,3,2.5,2424,5931,2.0,3,2424,0,98042
300000.0,4,2.5,2303,3826,2.0,3,2303,0,98092
284000.0,3,2.5,1880,6008,2.0,3,1880,0,98042
255900.0,3,2.5,1489,3266,2.0,3,1489,0,98002
380000.0,4,2.5,2130,4467,2.0,3,2130,0,98146
580000.0,3,2.75,1430,1521,2.0,3,1130,300,98119
451300.0,3,2.5,1420,814,2.0,3,1140,280,98136
305000.0,4,2.5,1914,3150,2.0,3,1914,0,98055
261000.0,3,2.25,1584,2800,2.0,3,1584,0,98002
384950.0,4,2.5,2380,4913,2.0,3,2380,0,98038
799000.0,3,2.0,2550,4794,2.0,3,2550,0,98115
405000.0,3,2.5,1440,2163,2.0,3,1440,0,98029
379900.0,3,2.5,1800,2792,2.0,3,1800,0,98126
398096.0,3,2.5,2370,5321,2.0,3,2370,0,98038
315000.0,3,2.5,1410,1325,2.0,3,1180,230,98106
674000.0,3,2.5,1920,3624,2.0,3,1920,0,98052
306000.0,4,2.5,2267,3577,2.0,3,2267,0,98092
496000.0,3,2.5,2180,4533,2.0,3,2180,0,98011
310000.0,3,2.5,1300,3612,2.0,3,1300,0,98118
680000.0,4,2.75,2330,3920,2.0,3,2330,0,98029
274950.0,3,2.5,1608,4000,2.0,3,1608,0,98092
282900.0,4,2.5,1710,3500,2.0,3,1710,0,98002
256703.0,3,2.0,1670,4441,1.0,3,1670,0,98022
386380.0,3,2.5,1720,3600,2.0,3,1720,0,98053
275000.0,3,2.25,1450,4040,2.0,3,1450,0,98038
370000.0,4,2.5,1812,5026,2.0,3,1812,0,98055
554000.0,3,2.5,2140,4126,2.0,3,1960,180,98027
317500.0,4,2.5,2233,6025,2.0,3,2233,0,98001
333700.0,3,2.5,2230,5050,2.0,3,2230,0,98042
305000.0,4,2.5,1714,3250,2.0,3,1714,0,98055
440000.0,4,2.5,2230,5650,2.0,3,2230,0,98056
275000.0,4,2.5,2150,3721,2.0,3,2150,0,98002
540000.0,3,1.75,1630,1404,2.0,3,1020,610,98107
445000.0,3,2.5,2230,7934,2.0,3,2230,0,98065
480000.0,3,2.5,1590,1431,2.0,3,1060,530,98144
287450.0,3,2.5,1440,2500,2.0,3,1440,0,98146
380000.0,4,2.5,2110,5306,2.0,3,2110,0,98038
685000.0,4,2.5,2310,5100,2.0,3,2310,0,98177
259950.0,3,2.5,1578,7340,2.0,3,1578,0,98030
441000.0,3,2.0,1720,15000,1.0,3,1720,0,98014
497000.0,3,2.25,1460,1353,2.0,3,1050,410,98116
345500.0,3,2.5,1930,4000,2.0,3,1930,0,98001
562500.0,3,2.25,1300,907,2.0,3,1000,300,98102
355000.0,3,2.25,1445,1087,2.0,3,1300,145,98027
391500.0,3,2.5,2424,6143,2.0,3,2424,0,98030
395000.0,3,2.5,2510,5320,2.0,3,2510,0,98106
298900.0,3,2.5,1852,4000,2.0,3,1852,0,98002
775000.0,4,2.5,2580,5787,2.0,3,2580,0,98029
348000.0,3,2.0,2360,6145,1.0,3,2360,0,98030
380000.0,4,2.5,1984,32400,1.0,3,1564,420,98198
650000.0,3,2.75,1540,1251,2.0,3,1230,310,98102
345000.0,3,2.5,1680,2229,2.0,3,1680,0,98155
479950.0,3,2.0,2260,7163,1.0,3,2260,0,98058
253101.0,3,2.0,1239,6036,1.0,3,1239,0,98030
660000.0,3,2.5,2450,4332,2.0,3,2450,0,98053
425996.0,4,2.5,2568,5000,2.0,3,2568,0,98092
749950.0,3,2.5,2010,2263,2.0,3,1340,670,98122
674600.0,4,2.5,2610,5140,2.0,3,2610,0,98103
272000.0,3,2.5,1528,7616,2.0,3,1528,0,98030
290000.0,3,2.5,1420,3542,2.0,3,1310,110,98133
728050.0,3,2.5,2320,6775,1.0,3,2320,0,98053
536000.0,4,2.5,2520,4831,2.0,3,2520,0,98072
374000.0,3,2.5,2185,6042,2.0,3,2185,0,98030
182568.0,4,1.5,1500,2106,2.0,3,1500,0,98108
334888.0,3,2.5,1769,7324,2.0,3,1769,0,98092
383000.0,4,2.5,2160,6223,2.0,3,2160,0,98038
351999.0,3,2.5,2370,4200,2.0,3,2370,0,98038
312000.0,3,2.5,1780,4077,2.0,3,1780,0,98038
208800.0,3,2.5,1390,2450,2.0,3,1390,0,98118
369946.0,3,2.5,2420,4725,2.0,3,2420,0,98038
386000.0,4,2.5,2478,6079,2.0,3,2478,0,98030
329995.0,4,2.5,2303,3680,2.0,3,2303,0,98001
414000.0,3,2.5,1790,3754,2.0,3,1790,0,98065
435000.0,3,2.25,1230,1238,2.0,3,1080,150,98199
353000.0,4,2.5,1912,5000,2.0,3,1912,0,98001
329950.0,4,2.5,2300,9690,2.0,3,2300,0,98023
447500.0,4,2.5,2425,9017,2.0,3,2425,0,98001
399500.0,4,2.5,2560,7492,2.0,3,2560,0,98188
336900.0,3,2.5,1690,1200,2.0,3,1410,280,98106
299000.0,3,2.25,1350,3582,2.0,3,1350,0,98031
409000.0,3,2.5,1890,6500,2.0,3,1890,0,98074
275000.0,3,2.75,1740,5757,1.0,3,1740,0,98022
352800.0,4,2.25,1800,2752,2.0,3,1800,0,98106
765000.0,4,2.25,2030,2222,2.0,3,1610,420,98117
425000.0,4,2.5,1900,2766,2.0,3,1900,0,98106
274500.0,3,2.25,1450,4050,2.0,3,1450,0,98038
312000.0,3,2.25,1490,974,2.0,3,1220,270,98106
410000.0,3,2.5,2150,4332,2.0,3,2150,0,98019
335000.0,4,2.5,1900,3301,2.0,3,1900,0,98178
274900.0,3,2.0,1936,6612,2.0,3,1936,0,98001
350000.0,4,2.5,2040,22653,2.0,3,2040,0,98168
550000.0,4,2.5,2470,7539,2.0,3,2470,0,98028
311850.0,4,2.5,1890,4158,2.0,3,1890,0,98042
375000.0,4,2.5,2250,5306,2.0,3,2250,0,98038
299999.0,3,2.25,1350,1234,2.0,3,1160,190,98106
436000.0,3,2.5,1460,1238,2.0,3,1200,260,98107
303000.0,3,2.5,2056,3564,2.0,3,2056,0,98092
329950.0,3,2.5,2456,7566,2.0,3,2456,0,98023
400000.0,3,2.0,1650,5027,1.5,3,1650,0,98065
286950.0,4,2.5,1610,4052,2.0,3,1610,0,98042
375000.0,3,2.5,1580,2407,2.0,3,1580,0,98126
294500.0,3,2.5,1760,2688,2.0,3,1760,0,98059
280000.0,4,2.5,1934,5677,2.0,3,1934,0,98001
605000.0,3,2.75,2450,5750,2.0,3,2450,0,98065
549900.0,3,2.0,1280,960,2.0,3,1040,240,98122
379950.0,4,2.5,2580,4818,2.0,3,2580,0,98038
269800.0,4,2.75,1830,3420,2.0,3,1830,0,98198
389700.0,3,2.5,1720,3581,2.0,3,1720,0,98053
324500.0,3,2.5,1660,3990,2.0,3,1660,0,98118
525000.0,4,2.75,2360,4924,2.0,3,2360,0,98028
370950.0,3,2.5,2529,9653,2.0,3,2529,0,98042
705000.0,3,2.5,1580,1321,2.0,3,1080,500,98107
268000.0,3,2.5,1700,2250,2.0,3,1700,0,98168
305450.0,3,2.5,1600,3573,2.0,3,1600,0,98056
303210.0,4,2.5,2009,5000,2.0,3,2009,0,98092
300000.0,3,2.5,2090,4590,2.0,3,2090,0,98042
899000.0,4,2.5,2580,3943,2.0,3,2580,0,98033
485000.0,3,2.5,2430,5867,2.0,3,2430,0,98065
409316.0,3,2.5,1800,3168,2.0,3,1800,0,98065
388598.0,3,2.5,2370,4200,2.0,3,2370,0,98038
415000.0,3,2.25,1445,1512,2.0,3,1300,145,98027
521500.0,3,2.25,1450,1619,2.0,3,1140,310,98122
284000.0,3,2.5,1660,4083,2.0,3,1660,0,98038
379500.0,3,2.25,1410,1287,2.0,3,1290,120,98027
294900.0,3,2.5,1860,5025,2.0,3,1860,0,98038
740000.0,3,2.5,2350,3798,2.0,3,2350,0,98029
535000.0,4,2.25,1890,3615,2.0,3,1890,0,98029
255000.0,3,2.25,1320,963,2.0,3,1040,280,98106
260000.0,4,2.5,2150,3721,2.0,3,2150,0,98002
359782.0,3,2.5,1850,3400,2.0,3,1850,0,98053
730000.0,4,2.5,2460,7930,2.0,3,2460,0,98033
327000.0,4,2.5,2110,3825,2.0,3,2110,0,98042
365000.0,4,2.5,2420,8404,2.0,3,2420,0,98042
255000.0,4,2.5,1987,6000,2.0,3,1987,0,98001
575000.0,4,2.5,2500,4945,2.0,3,2500,0,98065
288000.0,4,2.25,1610,3560,2.0,3,1610,0,98038
390000.0,3,2.25,1490,4539,2.0,3,1490,0,98028
487000.0,4,2.5,2540,5001,2.0,3,2540,0,98108
400950.0,4,2.5,2578,4554,2.0,3,2578,0,98092
544000.0,4,2.5,2340,6973,2.0,3,1930,410,98065
425000.0,4,2.5,2390,5021,2.0,3,2390,0,98065
374950.0,4,2.5,2090,3777,2.0,3,2090,0,98038
300000.0,3,2.5,1960,1477,2.0,3,1670,290,98059
439990.0,3,2.5,2340,5171,2.0,3,2340,0,98045
424950.0,3,2.5,1650,4777,2.0,3,1650,0,98065
359950.0,4,2.5,2542,6120,2.0,3,2542,0,98030
295000.0,3,2.5,1660,4898,2.0,3,1660,0,98038
255500.0,3,2.5,1770,5000,2.0,3,1770,0,98042
277950.0,4,2.5,1889,6000,2.0,3,1889,0,98001
447000.0,3,2.5,1740,3043,2.0,3,1740,0,98011
712198.0,4,2.5,2450,4247,2.0,3,2450,0,98052
333490.0,4,2.5,2250,3916,2.0,3,2250,0,98003
425000.0,4,2.5,1950,5000,2.0,3,1950,0,98065
307635.0,3,2.5,1820,4200,2.0,3,1820,0,98038
595500.0,4,2.5,2490,6537,2.0,3,2490,0,98065
300000.0,3,2.0,1451,7159,1.0,3,1451,0,98042
279800.0,3,1.75,1410,2052,2.0,3,1410,0,98106
345000.0,4,2.5,1983,6002,2.0,3,1983,0,98092
370000.0,3,2.5,2313,5700,2.0,3,2313,0,98030
449500.0,3,2.25,1260,2556,2.0,3,1260,0,98029
515000.0,3,2.5,2000,3837,2.0,3,2000,0,98072
250000.0,3,2.25,1481,2820,2.0,3,1481,0,98002
700000.0,3,2.5,2050,4185,2.0,3,2050,0,98117
494900.0,3,2.5,2040,2500,2.0,3,1470,570,98126
415000.0,3,2.5,1610,3600,2.0,3,1610,0,98072
375900.0,3,2.0,1824,7120,1.0,3,1824,0,98001
654000.0,3,2.5,2220,2873,2.0,3,2010,210,98027
215000.0,3,2.5,1322,6006,2.0,3,1322,0,98001
235245.0,4,2.5,1954,5075,2.0,3,1954,0,98001
880000.0,4,2.5,2580,3436,2.0,3,2580,0,98033
663000.0,3,2.5,1910,5125,2.0,3,1910,0,98029
433190.0,3,2.5,1650,2787,2.0,3,1650,0,98065
279950.0,3,2.5,1608,4800,2.0,3,1608,0,98092
468500.0,3,2.5,1350,1186,2.0,3,1120,230,98117
298000.0,3,2.5,1950,3600,2.0,3,1950,0,98038
308000.0,3,1.75,1300,1237,2.0,3,1060,240,98027
530200.0,4,2.5,1880,3853,2.0,3,1880,0,98027
375500.0,4,2.5,2301,6452,2.0,3,2301,0,98001
477000.0,3,2.5,2100,5060,2.0,3,2100,0,98108
450000.0,3,2.75,2240,3360,2.0,3,2100,140,98178
590000.0,3,2.5,1710,2875,2.0,3,1710,0,98116
385000.0,4,2.5,2050,5276,2.0,3,2050,0,98059
425000.0,3,1.5,1680,8000,1.5,3,1680,0,98014
309000.0,3,2.5,1950,3825,2.0,3,1950,0,98042
391000.0,4,2.25,2190,3850,2.0,3,2190,0,98059
465000.0,3,1.75,1590,1322,2.0,3,1060,530,98144
372000.0,3,2.0,1330,1042,2.0,3,1060,270,98136
259000.0,3,2.5,1550,3569,2.0,3,1550,0,98002
561000.0,4,2.5,2550,5395,2.0,3,2550,0,98065
412500.0,3,2.0,1680,5246,1.0,3,1680,0,98065
497000.0,3,2.25,1630,3817,2.0,3,1630,0,98029
312000.0,3,2.5,1750,4076,2.0,3,1750,0,98038
299000.0,3,2.5,1572,4000,2.0,3,1572,0,98092
332000.0,4,2.5,2300,4482,2.0,3,2300,0,98042
452000.0,4,2.5,2190,6896,2.0,3,2190,0,98065
494000.0,3,2.5,2310,4729,2.0,3,2310,0,98028
429900.0,3,2.5,2370,5353,2.0,3,2370,0,98019
272000.0,4,2.0,1870,6551,1.0,3,1870,0,98022
249950.0,3,2.0,1670,4438,1.0,3,1670,0,98022
722000.0,3,2.5,2230,4850,2.0,3,2230,0,98133
567500.0,3,2.5,2280,2502,2.0,3,1880,400,98027
400000.0,4,2.5,2398,5988,2.0,3,2398,0,98055
459995.0,4,2.5,2350,3760,2.0,3,2350,0,98059
415500.0,4,2.5,1750,4779,2.0,3,1750,0,98028
378950.0,4,2.5,1867,15314,2.0,3,1867,0,98030
335900.0,4,2.75,2475,4000,2.0,3,2475,0,98002
706000.0,4,2.5,2510,5436,2.0,3,2510,0,98053
300000.0,4,2.5,1914,3272,2.0,3,1914,0,98055
773000.0,3,2.75,2470,3600,2.0,3,2470,0,98029
480000.0,3,2.5,2410,4656,2.0,3,2410,0,98065
355000.0,3,2.25,1430,4777,2.0,3,1430,0,98059
279500.0,4,2.5,1613,4338,2.0,3,1613,0,98042
445000.0,3,2.5,2380,5269,2.0,3,2380,0,98056
435000.0,4,2.5,2550,5200,2.0,3,2550,0,98059
495000.0,3,2.25,1280,1517,2.0,3,1080,200,98107
490000.0,4,2.5,2510,4349,2.0,3,2510,0,98059
440000.0,3,2.5,1650,4929,2.0,3,1520,130,98108
452000.0,3,2.75,2300,5090,2.0,3,1700,600,98106
305000.0,4,2.5,2280,3800,2.0,3,2280,0,98038
417000.0,3,2.5,2000,4500,2.0,3,2000,0,98059
338000.0,3,2.5,1690,1760,2.0,3,1410,280,98106
608000.0,3,2.25,1720,5234,2.0,3,1240,480,98118
667000.0,3,2.5,2510,3819,2.0,3,2510,0,98052
345000.0,4,2.5,2280,5000,2.0,3,2280,0,98038
295000.0,3,2.0,1230,3405,1.0,3,1230,0,98058
405000.0,3,2.5,1500,2314,2.0,3,1500,0,98029
410000.0,4,2.25,2510,4090,2.0,3,1840,670,98019
382000.0,3,2.25,1450,4667,2.0,3,1450,0,98028
365000.0,3,2.25,1310,915,2.0,3,1060,250,98144
409000.0,3,2.5,1950,7263,2.0,3,1950,0,98065
391000.0,3,2.5,1800,1120,2.0,3,1800,0,98126
392000.0,4,2.5,2130,4028,2.0,3,2130,0,98146
274800.0,3,1.75,1410,1988,2.0,3,1410,0,98106
325000.0,3,2.25,1330,1198,2.0,3,1080,250,98106
418500.0,4,2.5,2190,4866,2.0,3,2190,0,98059
300000.0,3,2.5,2540,5050,2.0,3,2540,0,98042
269950.0,3,2.5,2244,4079,2.0,3,2244,0,98001
358000.0,3,2.5,2026,7611,2.0,3,2026,0,98042
350000.0,3,2.5,1730,4086,2.0,3,1730,0,98146
685000.0,4,2.5,2510,3479,2.0,3,2510,0,98052
350000.0,4,2.5,1660,2500,2.0,3,1660,0,98118
317750.0,3,2.5,1980,4500,2.0,3,1980,0,98042
353000.0,3,2.25,1900,3800,2.0,3,1900,0,98059
460000.0,4,2.5,2200,6400,2.0,3,2200,0,98059
330000.0,3,2.5,2238,7209,2.0,3,2238,0,98023
569888.0,4,2.5,2590,6474,2.0,3,2590,0,98056
353900.0,3,2.5,2517,3900,2.0,3,2517,0,98092
288790.0,3,1.75,1290,1237,2.0,3,1060,230,98027
389990.0,4,2.5,2245,4330,2.0,3,2245,0,98038
299950.0,3,2.5,1740,4497,2.0,3,1740,0,98042
365000.0,3,2.5,1800,2700,2.0,3,1800,0,98126
700000.0,3,2.5,2230,4006,2.0,3,2230,0,98133
255000.0,3,2.5,2555,5720,2.0,3,2555,0,98031
530000.0,3,2.5,1970,6295,2.0,3,1970,0,98065
639000.0,3,2.5,2010,3300,2.0,3,1610,400,98118
580000.0,3,2.0,1870,5300,1.0,3,1870,0,98053
358000.0,3,2.5,1400,1529,2.0,3,1400,0,98029
425000.0,3,2.5,1950,5689,2.0,3,1950,0,98065
326000.0,3,2.25,1930,3462,2.0,3,1930,0,98019
650000.0,4,2.5,2210,4861,2.0,3,2210,0,98117
239950.0,3,1.75,1600,4888,1.0,3,1600,0,98042
315000.0,3,2.5,1480,1590,2.0,3,1150,330,98106
337500.0,4,2.5,2330,4907,2.0,3,2330,0,98042
330000.0,3,2.5,1520,3003,2.0,3,1520,0,98059
433000.0,3,2.5,1270,1062,2.0,3,1060,210,98105
529000.0,3,1.75,2340,7724,1.0,3,2340,0,98058
649950.0,3,2.5,2420,6847,2.0,3,2420,0,98133
370000.0,3,1.75,1496,1423,2.0,3,1248,248,98133
443000.0,3,2.5,2430,7049,2.0,3,2430,0,98106
420000.0,3,2.5,1470,1571,2.0,3,1180,290,98116
579950.0,4,2.75,2460,8643,2.0,3,2460,0,98059
290000.0,3,2.25,1610,3764,2.0,3,1610,0,98042
535000.0,4,2.5,2610,4595,2.0,3,2610,0,98028
332000.0,4,2.5,2380,5737,2.0,3,2380,0,98023
370000.0,4,2.5,2531,6843,2.0,3,2531,0,98030
589999.0,3,2.5,2140,3628,2.0,3,1960,180,98027
405000.0,4,2.5,1980,5020,2.0,3,1980,0,98056
327500.0,3,2.5,1820,1866,2.0,3,1570,250,98166
465000.0,3,2.5,2050,15035,2.0,3,2050,0,98042
388000.0,3,2.5,2198,6222,2.0,3,2198,0,98198
530000.0,3,2.5,1410,1250,2.0,3,1140,270,98119
747450.0,3,2.5,2110,1339,2.0,3,1410,700,98122
337000.0,4,2.5,2470,5100,2.0,3,2470,0,98038
341780.0,4,2.75,2260,4440,2.0,3,2260,0,98001
490000.0,3,2.25,1500,1290,2.0,3,1220,280,98117
270000.0,3,2.5,1870,5000,2.0,3,1870,0,98042
347500.0,3,2.5,2540,4760,2.0,3,2540,0,98038
350000.0,4,2.75,2500,5995,2.0,3,2500,0,98042
224000.0,3,1.75,1500,11968,1.0,3,1500,0,98010
507250.0,3,2.5,2270,5536,2.0,3,2270,0,98065
610685.0,4,2.5,2520,6023,2.0,3,2520,0,98056
475000.0,3,2.5,1310,1294,2.0,3,1180,130,98116
400000.0,4,2.5,2310,5813,2.0,3,2310,0,98146
400000.0,3,2.5,1600,2388,2.0,3,1600,0,98027
